Semester;Code;Studiengang;männlich;weiblich;Insgesamt
WS 2010/11;SF141;Abfallwirtschaft;14;6;20
WS 2010/11;SF002;Afrikanistik;44;88;132
WS 2010/11;SF138;Agrarbiologie;40;62;102
WS 2010/11;SF125;Agrarökonomie;163;141;304
WS 2010/11;SF003;Agrarwissenschaft/Landwirtschaft;1478;1272;2750
WS 2010/11;SF001;Ägyptologie;12;52;64
WS 2010/11;SF152;Allg. Sprachwissenschaft/Indogermanistik;223;841;1064
WS 2010/11;SF188;Allgemeine Literaturwissenschaft;116;457;573
WS 2010/11;SF272;Alte Geschichte;13;18;31
WS 2010/11;SF006;Amerikanistik/Amerikakunde;121;369;490
WS 2010/11;SF007;Angewandte Kunst;236;393;629
WS 2010/11;SF284;Angewandte Sprachwissenschaft;167;881;1048
WS 2010/11;SF140;Angewandte Systemwissenschaften;256;109;365
WS 2010/11;SF008;Anglistik/Englisch;1733;5717;7450
WS 2010/11;SF009;Anthropologie (Humanbiologie);21;86;107
WS 2010/11;SF010;Arabisch/Arabistik;33;71;104
WS 2010/11;SF011;Arbeitslehre/Wirtschaftslehre;106;192;298
WS 2010/11;SF257;Arbeits- und Berufsberatung;3;32;35
WS 2010/11;SF258;Arbeitsverwaltung;61;152;213
WS 2010/11;SF012;Archäologie;249;388;637
WS 2010/11;SF390;Archäometrie (Ingenieurarchäologie);2;1;3
WS 2010/11;SF013;Architektur;2471;3466;5937
WS 2010/11;SF255;Archivwesen;23;39;62
WS 2010/11;SF187;Asiatische Sprachen u.Kulturen/Asienwissenschaften;91;203;294
WS 2010/11;SF014;Astronomie, Astrophysik;23;15;38
WS 2010/11;SF143;Augenoptik;50;140;190
WS 2010/11;SF117;Ausländerpädagogik;9;22;31
WS 2010/11;SF015;Außereurop. Sprachen und Kult. in Ozeanien und Am.;9;30;39
WS 2010/11;SF259;Auswärtige Angelegenheiten;16;19;35
WS 2010/11;SF016;Baltistik;2;6;8
WS 2010/11;SF265;Bankwesen;39;30;69
WS 2010/11;SF017;Bauingenieurwesen/Ingenieurbau;6757;2544;9301
WS 2010/11;SF020;Bergbau/Bergtechnik;256;57;313
WS 2010/11;SF018;Berufsbezogene Fremdsprachenausbildung;123;404;527
WS 2010/11;SF270;Berufs- und Wirtschaftspädagogik;106;89;195
WS 2010/11;SF021;Betriebswirtschaftslehre;16864;17912;34776
WS 2010/11;SF262;Bibliothekswesen;1;8;9
WS 2010/11;SF022;Bibliothekswiss., -wesen (nicht an Verw.-FH);103;433;536
WS 2010/11;SF023;Bildende Kunst/Grafik;246;278;524
WS 2010/11;SF205;Bildhauerei/Plastik;33;45;78
WS 2010/11;SF025;Biochemie;591;723;1314
WS 2010/11;SF283;Biogeographie (ab 2012 ohne SF385);108;190;298
WS 2010/11;SF221;Bioinformatik;247;137;384
WS 2010/11;SF026;Biologie;2556;5292;7848
WS 2010/11;SF300;Biomedizin;80;99;179
WS 2010/11;SF282;Biotechnologie;866;1092;1958
WS 2010/11;SF027;Blinden-/Sehbehindertenpädagogik(ab 2016 zu SF190);-;2;2
WS 2010/11;SF028;Brauwesen/Getränketechnologie;135;22;157
WS 2010/11;SF260;Bundeswehrverwaltung;29;58;87
WS 2010/11;SF031;Byzantinistik;-;3;3
WS 2010/11;SF162;Caritaswissenschaft;-;-;-
WS 2010/11;SF032;Chemie;3583;2681;6264
WS 2010/11;SF033;Chemie-Ingenieurwesen/Chemietechnik;1013;570;1583
WS 2010/11;SF160;Computerlinguistik;73;77;150
WS 2010/11;SF200;Computer- und Kommunikationstechniken;383;162;545
WS 2010/11;SF034;Dänisch;3;17;20
WS 2010/11;SF035;Darstellende Kunst/Bühnenkunst/Regie;85;172;257
WS 2010/11;SF271;Deutsch als Fremdsprache oder als Zweitsprache;82;370;452
WS 2010/11;SF161;Diakoniewissenschaft;14;15;29
WS 2010/11;SF192;Dirigieren;19;8;27
WS 2010/11;SF037;Dokumentationswissenschaft;21;39;60
WS 2010/11;SF231;Druck- und Reproduktionstechnik;379;220;599
WS 2010/11;SF159;Edelstein- und Schmuckdesign;2;21;23
WS 2010/11;SF316;Elektronische Energietechnik;321;38;359
WS 2010/11;SF048;Elektrotechnik/Elektronik;10127;1051;11178
WS 2010/11;SF211;Energietechnik (ohne Elektrotechnik);1270;233;1503
WS 2010/11;SF320;Ernährungswissenschaft;41;359;400
WS 2010/11;SF321;Erwachsenenbildung und außerschulische Jugendbild.;24;93;117
WS 2010/11;SF051;Erziehungsschwierigenpädagogik (ab 2016 zu SF190);1;5;6
WS 2010/11;SF052;Erziehungswissenschaft (Pädagogik);1432;6400;7832
WS 2010/11;SF169;Ethik;20;39;59
WS 2010/11;SF173;Ethnologie;122;530;652
WS 2010/11;SF024;Europäische Ethnologie und Kulturwissenschaft;101;434;535
WS 2010/11;SF167;Europäische Wirtschaft;239;367;606
WS 2010/11;SF544;Ev. Religionspädagogik, kirchliche Bildungsarbeit;34;93;127
WS 2010/11;SF053;Evangelische Theologie, - Religionslehre;430;758;1188
WS 2010/11;SF464;Facility Management;231;198;429
WS 2010/11;SF235;Fahrzeugtechnik;2053;110;2163
WS 2010/11;SF212;Feinwerktechnik;183;19;202
WS 2010/11;SF202;Fertigungs-/Produktionstechnik;1082;157;1239
WS 2010/11;SF054;Film und Fernsehen;182;149;331
WS 2010/11;SF266;Finanzverwaltung;201;313;514
WS 2010/11;SF056;Finno-Ugristik;5;22;27
WS 2010/11;SF058;Forstwissenschaft, -wirtschaft;695;310;1005
WS 2010/11;SF059;Französisch;237;1311;1548
WS 2010/11;SF019;Friesisch (2007 aufgelöst);-;-;-
WS 2010/11;SF060;Gartenbau;187;170;357
WS 2010/11;SF062;Gehörlosen-/Schwerhörigenpäd. (ab 2016 zu SF190);5;80;85
WS 2010/11;SF063;Geistigbeh./Prakt.-Bildb.-Pädag.(ab 2016 zu SF190);46;162;208
WS 2010/11;SF050;Geografie/Erdkunde;1503;1740;3243
WS 2010/11;SF065;Geologie/Paläontologie;49;24;73
WS 2010/11;SF385;Geoökologie;-;-;-
WS 2010/11;SF066;Geophysik;132;82;214
WS 2010/11;SF039;Geowissenschaften;1100;752;1852
WS 2010/11;SF067;Germanistik/Deutsch;2707;11027;13734
WS 2010/11;SF230;Gesang;69;126;195
WS 2010/11;SF068;Geschichte;2336;2056;4392
WS 2010/11;SF275;Geschichte der Mathematik und Naturwissenschaft;4;2;6
WS 2010/11;SF195;Gesundheitspädagogik;50;366;416
WS 2010/11;SF215;Gesundheitstechnik;1099;804;1903
WS 2010/11;SF232;Gesundheitswissenschaften/-management;957;2411;3368
WS 2010/11;SF216;Glastechnik/Keramik;33;9;42
WS 2010/11;SF069;Grafikdesign/Kommunikationsgestaltung;1076;1480;2556
WS 2010/11;SF070;Griechisch;29;36;65
WS 2010/11;SF115;Grundschul-/Primärstufenpädagogik;47;383;430
WS 2010/11;SF071;Haushalts- und Ernährungswissenschaft;192;995;1187
WS 2010/11;SF333;Haushaltswissenschaft;-;24;24
WS 2010/11;SF073;Hebräisch/Judaistik;9;29;38
WS 2010/11;SF082;Holz-/Fasertechnik;190;20;210
WS 2010/11;SF197;Holzbau;137;19;156
WS 2010/11;SF075;Holzwirtschaft;40;7;47
WS 2010/11;SF076;Hütten- und Gießereiwesen;105;39;144
WS 2010/11;SF078;Indologie;9;10;19
WS 2010/11;SF203;Industriedesign/Produktgestaltung;240;249;489
WS 2010/11;SF079;Informatik;8904;1441;10345
WS 2010/11;SF123;Ingenieurinformatik/Technische Informatik;1264;131;1395
WS 2010/11;SF242;Innenarchitektur;88;493;581
WS 2010/11;SF261;Innere Verwaltung;334;525;859
WS 2010/11;SF080;Instrumentalmusik;545;650;1195
WS 2010/11;SF072;Interdisz. Studien (Schwerp. Ingenieurwissensch.);2024;645;2669
WS 2010/11;SF049;Interdisz. Studien (Schwerp. Naturwissenschaften);355;365;720
WS 2010/11;SF030;Interdisz.Studien(Schwerp.Rechts-,Wirt.-u.Sozialw);631;1101;1732
WS 2010/11;SF004;Interdisz.Studien (Schwerpkt.Sprach-u.Kulturwiss.);753;2731;3484
WS 2010/11;SF040;Interdisz. Studien (Schwerpunkt Kunst, Kunstwiss.);33;87;120
WS 2010/11;SF182;Internationale Betriebswirtschaft/Management;2807;4245;7052
WS 2010/11;SF081;Iranistik;12;22;34
WS 2010/11;SF292;Islamische Studien;-;-;-
WS 2010/11;SF083;Islamwissenschaft;76;120;196
WS 2010/11;SF084;Italienisch;30;220;250
WS 2010/11;SF085;Japanologie;173;388;561
WS 2010/11;SF164;Jazz und Popularmusik;135;43;178
WS 2010/11;SF252;Journalistik (ab 2008 zu SF303);-;-;-
WS 2010/11;SF168;Justizvollzug;17;21;38
WS 2010/11;SF280;Kartografie;113;77;190
WS 2010/11;SF545;Kath. Religionspäd., kirchliche Bildungsarbeit;42;62;104
WS 2010/11;SF086;Katholische Theologie, - Religionslehre;302;435;737
WS 2010/11;SF180;Kaukasistik;-;-;-
WS 2010/11;SF241;Kerntechnik/Kernverfahrenstechnik;-;-;-
WS 2010/11;SF193;Kirchenmusik;36;23;59
WS 2010/11;SF005;Klassische Philologie;25;35;60
WS 2010/11;SF222;Kommunikations- und Informationstechnik;1419;185;1604
WS 2010/11;SF303;Kommunikationswissenschaft/Publizistik;699;1761;2460
WS 2010/11;SF191;Komposition;30;13;43
WS 2010/11;SF087;Körperbehindertenpädagogik (ab 2016 zu SF190);13;27;40
WS 2010/11;SF047;Krankenpflege-Ausbildung (ab 2004 zu SF234);-;-;-
WS 2010/11;SF091;Kunsterziehung;126;554;680
WS 2010/11;SF092;Kunstgeschichte, Kunstwissenschaft;262;1434;1696
WS 2010/11;SF219;Kunststofftechnik;256;38;294
WS 2010/11;SF093;Landespflege/Landschaftsgestaltung;416;578;994
WS 2010/11;SF095;Latein;231;414;645
WS 2010/11;SF038;Lateinamerika;12;53;65
WS 2010/11;SF096;Lebensmittelchemie;110;297;407
WS 2010/11;SF097;Lebensmitteltechnologie;383;439;822
WS 2010/11;SF099;Lernbehindertenpädagogik (ab 2016 zu SF190);85;390;475
WS 2010/11;SF154;Lernbereich Gesellschaftslehre;8;14;22
WS 2010/11;SF186;Lernbereich Naturwissenschaft/Sachunterricht;17;45;62
WS 2010/11;SF090;Lernbereich Sprach- und Kulturwissenschaften;13;58;71
WS 2010/11;SF199;Lernbereich Technik;89;49;138
WS 2010/11;SF057;Luft- und Raumfahrttechnik;907;127;1034
WS 2010/11;SF204;Malerei;37;65;102
WS 2010/11;SF198;Managem.im Gesundh.-u.Sozialber.(ab 2004 zu SF232);-;-;-
WS 2010/11;SF103;Markscheidewesen;7;2;9
WS 2010/11;SF104;Maschinenbau/-wesen;16687;1736;18423
WS 2010/11;SF294;Materialwissenschaften;-;-;-
WS 2010/11;SF105;Mathematik;4600;5587;10187
WS 2010/11;SF237;Mathematische Statistik/Wahrscheinlichkeitsrechn.;94;72;166
WS 2010/11;SF380;Mechatronik;2526;201;2727
WS 2010/11;SF121;Medieninformatik;1638;755;2393
WS 2010/11;SF133;Medienk./Komm.-/Infowissenschaft (ab 08 zu SF303);-;-;-
WS 2010/11;SF305;Medientechnik;317;186;503
WS 2010/11;SF304;Medienwirtschaft/Medienmanagement;371;658;1029
WS 2010/11;SF302;Medienwissenschaft;376;1055;1431
WS 2010/11;SF107;Medizin (Allgemein-Medizin);3528;5691;9219
WS 2010/11;SF247;Medizinische Informatik;202;179;381
WS 2010/11;SF061;Meliorationswesen;-;-;-
WS 2010/11;SF108;Metalltechnik;126;17;143
WS 2010/11;SF110;Meteorologie;167;147;314
WS 2010/11;SF157;Mikroelektronik;13;3;16
WS 2010/11;SF286;Mikrosystemtechnik;351;60;411
WS 2010/11;SF220;Milch- und Molkereiwirtschaft;10;16;26
WS 2010/11;SF111;Mineralogie;2;1;3
WS 2010/11;SF273;Mittlere und neuere Geschichte;26;19;45
WS 2010/11;SF113;Musikerziehung;350;591;941
WS 2010/11;SF114;Musikwissenschaft/-geschichte;385;433;818
WS 2010/11;SF064;Naturschutz;53;64;117
WS 2010/11;SF223;Nautik/Seefahrt;229;48;277
WS 2010/11;SF287;Neue Medien;202;241;443
WS 2010/11;SF043;Neugriechisch;3;8;11
WS 2010/11;SF233;Nichtärztliche Heilberufe/Therapien;160;838;998
WS 2010/11;SF189;Niederdeutsch;-;-;-
WS 2010/11;SF119;Niederländisch;22;47;69
WS 2010/11;SF120;Nordistik/Skandinavist.(Nord.Phil.,Einzelsp.a.n.g);85;236;321
WS 2010/11;SF088;Optoelektronik;129;36;165
WS 2010/11;SF165;Orchestermusik;102;121;223
WS 2010/11;SF122;Orientalistik, Altorientalistik;85;133;218
WS 2010/11;SF044;Ost- und Südosteuropa;27;118;145
WS 2010/11;SF124;Ozeanografie;2;7;9
WS 2010/11;SF365;Pädagogik der frühen Kindheit;-;-;-
WS 2010/11;SF353;Pflanzenproduktion;38;22;60
WS 2010/11;SF234;Pflegewissenschaft/-management;217;724;941
WS 2010/11;SF126;Pharmazie;478;1302;1780
WS 2010/11;SF127;Philosophie;1221;1055;2276
WS 2010/11;SF128;Physik;4347;1134;5481
WS 2010/11;SF224;Physikalische Technik;491;101;592
WS 2010/11;SF129;Politikwissenschaft/Politologie;2424;2218;4642
WS 2010/11;SF263;Polizei/Verfassungsschutz;2124;1110;3234
WS 2010/11;SF206;Polnisch;9;38;47
WS 2010/11;SF131;Portugiesisch;5;25;30
WS 2010/11;SF132;Psychologie;1388;5265;6653
WS 2010/11;SF109;Publizistik (ab 2008 zu SF303);-;-;-
WS 2010/11;SF134;Raumplanung;349;445;794
WS 2010/11;SF256;Rechtspflege;159;470;629
WS 2010/11;SF135;Rechtswissenschaft;5827;8692;14519
WS 2010/11;SF310;Regenerative Energien;-;-;-
WS 2010/11;SF136;Religionswissenschaft;57;116;173
WS 2010/11;SF101;Restaurierungskunde;22;130;152
WS 2010/11;SF163;Rhythmik;-;-;-
WS 2010/11;SF137;Romanistik (Roman.Philologie,Einzelsprach. a.n.g.);146;756;902
WS 2010/11;SF139;Russisch;35;171;206
WS 2010/11;SF254;Sachunterricht (einschließlich Schulgarten);1;9;10
WS 2010/11;SF102;Schauspiel;48;44;92
WS 2010/11;SF142;Schiffbau/Schiffstechnik;156;21;177
WS 2010/11;SF361;Schulpädagogik;11;25;36
WS 2010/11;SF145;Sinologie/Koreanistik;135;311;446
WS 2010/11;SF146;Slawistik (Slawische Philologie);78;276;354
WS 2010/11;SF190;Sonderpädagogik;110;625;735
WS 2010/11;SF290;Sonstige Fächer;463;573;1036
WS 2010/11;SF036;Sonstige Regionalwissenschaften;55;111;166
WS 2010/11;SF207;Sorbisch;4;11;15
WS 2010/11;SF208;Soziale Arbeit;1109;4261;5370
WS 2010/11;SF147;Sozialkunde;205;259;464
WS 2010/11;SF046;Sozialmed./Öff. Gesundheitsw. (ab 2004 zu SF232);-;-;-
WS 2010/11;SF245;Sozialpädagogik;232;935;1167
WS 2010/11;SF264;Sozialversicherung;144;324;468
WS 2010/11;SF253;Sozialwesen;843;3542;4385
WS 2010/11;SF148;Sozialwissenschaft;1046;1728;2774
WS 2010/11;SF149;Soziologie;1003;2097;3100
WS 2010/11;SF150;Spanisch;200;892;1092
WS 2010/11;SF166;Sportmanagement/Sportökonomie;384;154;538
WS 2010/11;SF098;Sportpädagogik/Sportpsychologie;782;669;1451
WS 2010/11;SF029;Sportwissenschaft;1363;939;2302
WS 2010/11;SF151;Sprachheilpädagogik/Logopädie (ab 2016 zu SF190);8;139;147
WS 2010/11;SF429;Stahlbau;12;-;12
WS 2010/11;SF196;Studienkolleg;-;-;-
WS 2010/11;SF153;Südslawisch(Bulgarisch,Serbokroatisch,Slowen.usw.);2;4;6
WS 2010/11;SF106;Tanzpädagogik;23;58;81
WS 2010/11;SF144;Technische Kybernetik;78;24;102
WS 2010/11;SF118;Technomathematik;227;57;284
WS 2010/11;SF116;Textilgestaltung;49;490;539
WS 2010/11;SF225;Textil- und Bekleidungstechnik/-gewerbe;80;460;540
WS 2010/11;SF155;Theaterwissenschaft;112;367;479
WS 2010/11;SF156;Tiermedizin/Veterinärmedizin;163;884;1047
WS 2010/11;SF371;Tierproduktion;2;2;4
WS 2010/11;SF194;Tonmeister;19;4;23
WS 2010/11;SF274;Tourismuswirtschaft;364;1255;1619
WS 2010/11;SF074;Transport-/Fördertechnik;58;4;62
WS 2010/11;SF209;Tschechisch;3;21;24
WS 2010/11;SF158;Turkologie;10;47;57
WS 2010/11;SF458;Umweltschutz;325;247;572
WS 2010/11;SF457;Umwelttechnik (einschließlich Recycling);1140;450;1590
WS 2010/11;SF548;Ur- und Frühgeschichte;21;31;52
WS 2010/11;SF226;Verfahrenstechnik;1260;684;1944
WS 2010/11;SF170;Verhaltensgestörtenpädagogik (ab 2016 zu SF190);14;80;94
WS 2010/11;SF089;Verkehrsingenieurwesen;567;198;765
WS 2010/11;SF268;Verkehrswesen;-;-;-
WS 2010/11;SF210;Verkehrswirtschaft;160;135;295
WS 2010/11;SF171;Vermessungswesen (Geodäsie);619;249;868
WS 2010/11;SF213;Versorgungstechnik;710;126;836
WS 2010/11;SF172;Verwaltungswissenschaft/-wesen;1017;1644;2661
WS 2010/11;SF174;Volkskunde;60;247;307
WS 2010/11;SF175;Volkswirtschaftslehre;2186;1371;3557
WS 2010/11;SF094;Wasserbau;52;25;77
WS 2010/11;SF077;Wasserwirtschaft;187;114;301
WS 2010/11;SF227;Weinbau und Kellerwirtschaft;135;71;206
WS 2010/11;SF201;Werken (technisch)/Technologie;27;36;63
WS 2010/11;SF176;Werkerziehung;4;6;10
WS 2010/11;SF177;Werkstofftechnik;905;281;1186
WS 2010/11;SF130;Westslawisch (allgemein und a.n.g.);1;13;14
WS 2010/11;SF178;Wirtschafts-/Sozialgeografie;1;-;1
WS 2010/11;SF183;Wirtschafts-/Sozialgeschichte;7;10;17
WS 2010/11;SF277;Wirtschaftsinformatik;5766;1457;7223
WS 2010/11;SF370;Wirtschaftsingenieurw. m. ingenieurwiss.Schwerpkt.;5548;1336;6884
WS 2010/11;SF179;Wirtschaftsingenieurw.m.wirtschaftswiss.Schwerpkt.;5858;1820;7678
WS 2010/11;SF276;Wirtschaftsmathematik;783;548;1331
WS 2010/11;SF181;Wirtschaftspädagogik;329;627;956
WS 2010/11;SF042;Wirtschaftsrecht;1157;1590;2747
WS 2010/11;SF184;Wirtschaftswissenschaften;6284;6090;12374
WS 2010/11;SF185;Zahnmedizin;453;952;1405
WS 2010/11;SF269;Zoll- und Steuerverwaltung;445;660;1105
WS 2011/12;SF141;Abfallwirtschaft;15;5;20
WS 2011/12;SF002;Afrikanistik;105;176;281
WS 2011/12;SF138;Agrarbiologie;55;62;117
WS 2011/12;SF125;Agrarökonomie;178;145;323
WS 2011/12;SF003;Agrarwissenschaft/Landwirtschaft;1571;1350;2921
WS 2011/12;SF001;Ägyptologie;31;47;78
WS 2011/12;SF152;Allg. Sprachwissenschaft/Indogermanistik;248;906;1154
WS 2011/12;SF188;Allgemeine Literaturwissenschaft;140;475;615
WS 2011/12;SF272;Alte Geschichte;13;20;33
WS 2011/12;SF006;Amerikanistik/Amerikakunde;173;442;615
WS 2011/12;SF007;Angewandte Kunst;310;423;733
WS 2011/12;SF284;Angewandte Sprachwissenschaft;168;771;939
WS 2011/12;SF140;Angewandte Systemwissenschaften;251;102;353
WS 2011/12;SF008;Anglistik/Englisch;2045;5644;7689
WS 2011/12;SF009;Anthropologie (Humanbiologie);37;78;115
WS 2011/12;SF010;Arabisch/Arabistik;41;55;96
WS 2011/12;SF011;Arbeitslehre/Wirtschaftslehre;67;133;200
WS 2011/12;SF257;Arbeits- und Berufsberatung;7;32;39
WS 2011/12;SF258;Arbeitsverwaltung;45;124;169
WS 2011/12;SF012;Archäologie;343;452;795
WS 2011/12;SF390;Archäometrie (Ingenieurarchäologie);1;-;1
WS 2011/12;SF013;Architektur;2970;3993;6963
WS 2011/12;SF255;Archivwesen;17;24;41
WS 2011/12;SF187;Asiatische Sprachen u.Kulturen/Asienwissenschaften;114;275;389
WS 2011/12;SF014;Astronomie, Astrophysik;32;17;49
WS 2011/12;SF143;Augenoptik;39;115;154
WS 2011/12;SF117;Ausländerpädagogik;3;16;19
WS 2011/12;SF015;Außereurop. Sprachen und Kult. in Ozeanien und Am.;21;24;45
WS 2011/12;SF259;Auswärtige Angelegenheiten;11;10;21
WS 2011/12;SF016;Baltistik;3;4;7
WS 2011/12;SF265;Bankwesen;42;39;81
WS 2011/12;SF017;Bauingenieurwesen/Ingenieurbau;8292;2833;11125
WS 2011/12;SF020;Bergbau/Bergtechnik;310;58;368
WS 2011/12;SF018;Berufsbezogene Fremdsprachenausbildung;112;348;460
WS 2011/12;SF270;Berufs- und Wirtschaftspädagogik;108;101;209
WS 2011/12;SF021;Betriebswirtschaftslehre;20760;20419;41179
WS 2011/12;SF262;Bibliothekswesen;-;1;1
WS 2011/12;SF022;Bibliothekswiss., -wesen (nicht an Verw.-FH);83;391;474
WS 2011/12;SF023;Bildende Kunst/Grafik;225;307;532
WS 2011/12;SF205;Bildhauerei/Plastik;35;33;68
WS 2011/12;SF025;Biochemie;645;744;1389
WS 2011/12;SF283;Biogeographie (ab 2012 ohne SF385);116;182;298
WS 2011/12;SF221;Bioinformatik;263;150;413
WS 2011/12;SF026;Biologie;3063;5411;8474
WS 2011/12;SF300;Biomedizin;100;142;242
WS 2011/12;SF282;Biotechnologie;1142;1209;2351
WS 2011/12;SF027;Blinden-/Sehbehindertenpädagogik(ab 2016 zu SF190);-;-;-
WS 2011/12;SF028;Brauwesen/Getränketechnologie;176;28;204
WS 2011/12;SF260;Bundeswehrverwaltung;9;22;31
WS 2011/12;SF031;Byzantinistik;3;3;6
WS 2011/12;SF162;Caritaswissenschaft;1;3;4
WS 2011/12;SF032;Chemie;4966;3127;8093
WS 2011/12;SF033;Chemie-Ingenieurwesen/Chemietechnik;1419;685;2104
WS 2011/12;SF160;Computerlinguistik;98;89;187
WS 2011/12;SF200;Computer- und Kommunikationstechniken;402;226;628
WS 2011/12;SF034;Dänisch;3;11;14
WS 2011/12;SF035;Darstellende Kunst/Bühnenkunst/Regie;83;195;278
WS 2011/12;SF271;Deutsch als Fremdsprache oder als Zweitsprache;111;442;553
WS 2011/12;SF161;Diakoniewissenschaft;11;15;26
WS 2011/12;SF192;Dirigieren;21;6;27
WS 2011/12;SF037;Dokumentationswissenschaft;30;51;81
WS 2011/12;SF231;Druck- und Reproduktionstechnik;249;200;449
WS 2011/12;SF159;Edelstein- und Schmuckdesign;3;19;22
WS 2011/12;SF316;Elektronische Energietechnik;474;55;529
WS 2011/12;SF048;Elektrotechnik/Elektronik;12690;1357;14047
WS 2011/12;SF211;Energietechnik (ohne Elektrotechnik);1783;337;2120
WS 2011/12;SF320;Ernährungswissenschaft;69;380;449
WS 2011/12;SF321;Erwachsenenbildung und außerschulische Jugendbild.;24;86;110
WS 2011/12;SF051;Erziehungsschwierigenpädagogik (ab 2016 zu SF190);19;99;118
WS 2011/12;SF052;Erziehungswissenschaft (Pädagogik);2121;8079;10200
WS 2011/12;SF169;Ethik;18;35;53
WS 2011/12;SF173;Ethnologie;189;577;766
WS 2011/12;SF024;Europäische Ethnologie und Kulturwissenschaft;133;498;631
WS 2011/12;SF167;Europäische Wirtschaft;209;302;511
WS 2011/12;SF544;Ev. Religionspädagogik, kirchliche Bildungsarbeit;42;118;160
WS 2011/12;SF053;Evangelische Theologie, - Religionslehre;473;692;1165
WS 2011/12;SF464;Facility Management;261;222;483
WS 2011/12;SF235;Fahrzeugtechnik;2479;159;2638
WS 2011/12;SF212;Feinwerktechnik;216;11;227
WS 2011/12;SF202;Fertigungs-/Produktionstechnik;1212;149;1361
WS 2011/12;SF054;Film und Fernsehen;159;171;330
WS 2011/12;SF266;Finanzverwaltung;206;276;482
WS 2011/12;SF056;Finno-Ugristik;7;24;31
WS 2011/12;SF058;Forstwissenschaft, -wirtschaft;847;375;1222
WS 2011/12;SF059;Französisch;244;1270;1514
WS 2011/12;SF019;Friesisch (2007 aufgelöst);-;-;-
WS 2011/12;SF060;Gartenbau;202;184;386
WS 2011/12;SF062;Gehörlosen-/Schwerhörigenpäd. (ab 2016 zu SF190);5;79;84
WS 2011/12;SF063;Geistigbeh./Prakt.-Bildb.-Pädag.(ab 2016 zu SF190);26;136;162
WS 2011/12;SF050;Geografie/Erdkunde;1671;1654;3325
WS 2011/12;SF065;Geologie/Paläontologie;59;42;101
WS 2011/12;SF385;Geoökologie;-;-;-
WS 2011/12;SF066;Geophysik;168;94;262
WS 2011/12;SF039;Geowissenschaften;1590;868;2458
WS 2011/12;SF067;Germanistik/Deutsch;3009;10825;13834
WS 2011/12;SF230;Gesang;85;104;189
WS 2011/12;SF068;Geschichte;2957;2320;5277
WS 2011/12;SF275;Geschichte der Mathematik und Naturwissenschaft;2;4;6
WS 2011/12;SF195;Gesundheitspädagogik;58;348;406
WS 2011/12;SF215;Gesundheitstechnik;1200;829;2029
WS 2011/12;SF232;Gesundheitswissenschaften/-management;1265;3353;4618
WS 2011/12;SF216;Glastechnik/Keramik;19;8;27
WS 2011/12;SF069;Grafikdesign/Kommunikationsgestaltung;1098;1543;2641
WS 2011/12;SF070;Griechisch;26;42;68
WS 2011/12;SF115;Grundschul-/Primärstufenpädagogik;49;341;390
WS 2011/12;SF071;Haushalts- und Ernährungswissenschaft;198;1100;1298
WS 2011/12;SF333;Haushaltswissenschaft;5;31;36
WS 2011/12;SF073;Hebräisch/Judaistik;21;35;56
WS 2011/12;SF082;Holz-/Fasertechnik;267;49;316
WS 2011/12;SF197;Holzbau;145;24;169
WS 2011/12;SF075;Holzwirtschaft;41;14;55
WS 2011/12;SF076;Hütten- und Gießereiwesen;150;38;188
WS 2011/12;SF078;Indologie;10;14;24
WS 2011/12;SF203;Industriedesign/Produktgestaltung;287;264;551
WS 2011/12;SF079;Informatik;11190;1795;12985
WS 2011/12;SF123;Ingenieurinformatik/Technische Informatik;1668;205;1873
WS 2011/12;SF242;Innenarchitektur;81;542;623
WS 2011/12;SF261;Innere Verwaltung;343;514;857
WS 2011/12;SF080;Instrumentalmusik;580;635;1215
WS 2011/12;SF072;Interdisz. Studien (Schwerp. Ingenieurwissensch.);2595;725;3320
WS 2011/12;SF049;Interdisz. Studien (Schwerp. Naturwissenschaften);421;377;798
WS 2011/12;SF030;Interdisz.Studien(Schwerp.Rechts-,Wirt.-u.Sozialw);781;983;1764
WS 2011/12;SF004;Interdisz.Studien (Schwerpkt.Sprach-u.Kulturwiss.);769;2703;3472
WS 2011/12;SF040;Interdisz. Studien (Schwerpunkt Kunst, Kunstwiss.);54;120;174
WS 2011/12;SF182;Internationale Betriebswirtschaft/Management;3616;4881;8497
WS 2011/12;SF081;Iranistik;12;16;28
WS 2011/12;SF292;Islamische Studien;-;-;-
WS 2011/12;SF083;Islamwissenschaft;106;227;333
WS 2011/12;SF084;Italienisch;46;247;293
WS 2011/12;SF085;Japanologie;217;362;579
WS 2011/12;SF164;Jazz und Popularmusik;162;58;220
WS 2011/12;SF252;Journalistik (ab 2008 zu SF303);-;-;-
WS 2011/12;SF168;Justizvollzug;21;18;39
WS 2011/12;SF280;Kartografie;103;68;171
WS 2011/12;SF545;Kath. Religionspäd., kirchliche Bildungsarbeit;29;80;109
WS 2011/12;SF086;Katholische Theologie, - Religionslehre;307;460;767
WS 2011/12;SF180;Kaukasistik;-;-;-
WS 2011/12;SF241;Kerntechnik/Kernverfahrenstechnik;2;1;3
WS 2011/12;SF193;Kirchenmusik;36;20;56
WS 2011/12;SF005;Klassische Philologie;24;58;82
WS 2011/12;SF222;Kommunikations- und Informationstechnik;1471;191;1662
WS 2011/12;SF303;Kommunikationswissenschaft/Publizistik;884;1936;2820
WS 2011/12;SF191;Komposition;37;14;51
WS 2011/12;SF087;Körperbehindertenpädagogik (ab 2016 zu SF190);11;47;58
WS 2011/12;SF047;Krankenpflege-Ausbildung (ab 2004 zu SF234);-;-;-
WS 2011/12;SF091;Kunsterziehung;134;528;662
WS 2011/12;SF092;Kunstgeschichte, Kunstwissenschaft;303;1438;1741
WS 2011/12;SF219;Kunststofftechnik;236;36;272
WS 2011/12;SF093;Landespflege/Landschaftsgestaltung;414;535;949
WS 2011/12;SF095;Latein;278;457;735
WS 2011/12;SF038;Lateinamerika;38;108;146
WS 2011/12;SF096;Lebensmittelchemie;136;361;497
WS 2011/12;SF097;Lebensmitteltechnologie;413;566;979
WS 2011/12;SF099;Lernbehindertenpädagogik (ab 2016 zu SF190);46;305;351
WS 2011/12;SF154;Lernbereich Gesellschaftslehre;21;25;46
WS 2011/12;SF186;Lernbereich Naturwissenschaft/Sachunterricht;26;120;146
WS 2011/12;SF090;Lernbereich Sprach- und Kulturwissenschaften;77;499;576
WS 2011/12;SF199;Lernbereich Technik;113;42;155
WS 2011/12;SF057;Luft- und Raumfahrttechnik;1128;129;1257
WS 2011/12;SF204;Malerei;41;44;85
WS 2011/12;SF198;Managem.im Gesundh.-u.Sozialber.(ab 2004 zu SF232);-;-;-
WS 2011/12;SF103;Markscheidewesen;3;-;3
WS 2011/12;SF104;Maschinenbau/-wesen;21046;2100;23146
WS 2011/12;SF294;Materialwissenschaften;-;-;-
WS 2011/12;SF105;Mathematik;5399;5212;10611
WS 2011/12;SF237;Mathematische Statistik/Wahrscheinlichkeitsrechn.;115;101;216
WS 2011/12;SF380;Mechatronik;3128;250;3378
WS 2011/12;SF121;Medieninformatik;1893;851;2744
WS 2011/12;SF133;Medienk./Komm.-/Infowissenschaft (ab 08 zu SF303);-;-;-
WS 2011/12;SF305;Medientechnik;602;307;909
WS 2011/12;SF304;Medienwirtschaft/Medienmanagement;519;820;1339
WS 2011/12;SF302;Medienwissenschaft;550;1389;1939
WS 2011/12;SF107;Medizin (Allgemein-Medizin);3622;5810;9432
WS 2011/12;SF247;Medizinische Informatik;326;200;526
WS 2011/12;SF061;Meliorationswesen;-;-;-
WS 2011/12;SF108;Metalltechnik;139;20;159
WS 2011/12;SF110;Meteorologie;219;107;326
WS 2011/12;SF157;Mikroelektronik;18;7;25
WS 2011/12;SF286;Mikrosystemtechnik;457;74;531
WS 2011/12;SF220;Milch- und Molkereiwirtschaft;17;20;37
WS 2011/12;SF111;Mineralogie;1;1;2
WS 2011/12;SF273;Mittlere und neuere Geschichte;11;8;19
WS 2011/12;SF113;Musikerziehung;397;516;913
WS 2011/12;SF114;Musikwissenschaft/-geschichte;417;452;869
WS 2011/12;SF064;Naturschutz;62;83;145
WS 2011/12;SF223;Nautik/Seefahrt;237;55;292
WS 2011/12;SF287;Neue Medien;265;241;506
WS 2011/12;SF043;Neugriechisch;3;8;11
WS 2011/12;SF233;Nichtärztliche Heilberufe/Therapien;212;995;1207
WS 2011/12;SF189;Niederdeutsch;1;1;2
WS 2011/12;SF119;Niederländisch;36;58;94
WS 2011/12;SF120;Nordistik/Skandinavist.(Nord.Phil.,Einzelsp.a.n.g);59;225;284
WS 2011/12;SF088;Optoelektronik;148;21;169
WS 2011/12;SF165;Orchestermusik;147;145;292
WS 2011/12;SF122;Orientalistik, Altorientalistik;100;160;260
WS 2011/12;SF044;Ost- und Südosteuropa;62;123;185
WS 2011/12;SF124;Ozeanografie;1;1;2
WS 2011/12;SF365;Pädagogik der frühen Kindheit;-;-;-
WS 2011/12;SF353;Pflanzenproduktion;38;29;67
WS 2011/12;SF234;Pflegewissenschaft/-management;250;977;1227
WS 2011/12;SF126;Pharmazie;571;1500;2071
WS 2011/12;SF127;Philosophie;1498;1205;2703
WS 2011/12;SF128;Physik;5900;1369;7269
WS 2011/12;SF224;Physikalische Technik;610;124;734
WS 2011/12;SF129;Politikwissenschaft/Politologie;2693;2194;4887
WS 2011/12;SF263;Polizei/Verfassungsschutz;2323;1148;3471
WS 2011/12;SF206;Polnisch;13;30;43
WS 2011/12;SF131;Portugiesisch;3;23;26
WS 2011/12;SF132;Psychologie;1692;5781;7473
WS 2011/12;SF109;Publizistik (ab 2008 zu SF303);-;-;-
WS 2011/12;SF134;Raumplanung;402;452;854
WS 2011/12;SF256;Rechtspflege;163;427;590
WS 2011/12;SF135;Rechtswissenschaft;7190;9428;16618
WS 2011/12;SF310;Regenerative Energien;-;-;-
WS 2011/12;SF136;Religionswissenschaft;75;123;198
WS 2011/12;SF101;Restaurierungskunde;28;140;168
WS 2011/12;SF163;Rhythmik;-;-;-
WS 2011/12;SF137;Romanistik (Roman.Philologie,Einzelsprach. a.n.g.);145;854;999
WS 2011/12;SF139;Russisch;39;138;177
WS 2011/12;SF254;Sachunterricht (einschließlich Schulgarten);6;17;23
WS 2011/12;SF102;Schauspiel;47;41;88
WS 2011/12;SF142;Schiffbau/Schiffstechnik;188;30;218
WS 2011/12;SF361;Schulpädagogik;16;51;67
WS 2011/12;SF145;Sinologie/Koreanistik;202;369;571
WS 2011/12;SF146;Slawistik (Slawische Philologie);95;263;358
WS 2011/12;SF190;Sonderpädagogik;125;816;941
WS 2011/12;SF290;Sonstige Fächer;528;600;1128
WS 2011/12;SF036;Sonstige Regionalwissenschaften;26;57;83
WS 2011/12;SF207;Sorbisch;2;1;3
WS 2011/12;SF208;Soziale Arbeit;1206;4652;5858
WS 2011/12;SF147;Sozialkunde;140;185;325
WS 2011/12;SF046;Sozialmed./Öff. Gesundheitsw. (ab 2004 zu SF232);-;-;-
WS 2011/12;SF245;Sozialpädagogik;189;991;1180
WS 2011/12;SF264;Sozialversicherung;189;355;544
WS 2011/12;SF253;Sozialwesen;885;3383;4268
WS 2011/12;SF148;Sozialwissenschaft;1174;1896;3070
WS 2011/12;SF149;Soziologie;982;1956;2938
WS 2011/12;SF150;Spanisch;282;1048;1330
WS 2011/12;SF166;Sportmanagement/Sportökonomie;432;175;607
WS 2011/12;SF098;Sportpädagogik/Sportpsychologie;913;712;1625
WS 2011/12;SF029;Sportwissenschaft;1481;813;2294
WS 2011/12;SF151;Sprachheilpädagogik/Logopädie (ab 2016 zu SF190);8;192;200
WS 2011/12;SF429;Stahlbau;14;-;14
WS 2011/12;SF196;Studienkolleg;-;-;-
WS 2011/12;SF153;Südslawisch(Bulgarisch,Serbokroatisch,Slowen.usw.);1;5;6
WS 2011/12;SF106;Tanzpädagogik;12;37;49
WS 2011/12;SF144;Technische Kybernetik;92;13;105
WS 2011/12;SF118;Technomathematik;246;70;316
WS 2011/12;SF116;Textilgestaltung;58;504;562
WS 2011/12;SF225;Textil- und Bekleidungstechnik/-gewerbe;70;414;484
WS 2011/12;SF155;Theaterwissenschaft;125;461;586
WS 2011/12;SF156;Tiermedizin/Veterinärmedizin;198;871;1069
WS 2011/12;SF371;Tierproduktion;3;6;9
WS 2011/12;SF194;Tonmeister;27;6;33
WS 2011/12;SF274;Tourismuswirtschaft;349;1426;1775
WS 2011/12;SF074;Transport-/Fördertechnik;68;6;74
WS 2011/12;SF209;Tschechisch;2;13;15
WS 2011/12;SF158;Turkologie;22;60;82
WS 2011/12;SF458;Umweltschutz;330;246;576
WS 2011/12;SF457;Umwelttechnik (einschließlich Recycling);1473;580;2053
WS 2011/12;SF548;Ur- und Frühgeschichte;32;33;65
WS 2011/12;SF226;Verfahrenstechnik;1483;696;2179
WS 2011/12;SF170;Verhaltensgestörtenpädagogik (ab 2016 zu SF190);24;98;122
WS 2011/12;SF089;Verkehrsingenieurwesen;690;191;881
WS 2011/12;SF268;Verkehrswesen;-;-;-
WS 2011/12;SF210;Verkehrswirtschaft;188;110;298
WS 2011/12;SF171;Vermessungswesen (Geodäsie);644;258;902
WS 2011/12;SF213;Versorgungstechnik;830;121;951
WS 2011/12;SF172;Verwaltungswissenschaft/-wesen;1198;1732;2930
WS 2011/12;SF174;Volkskunde;62;279;341
WS 2011/12;SF175;Volkswirtschaftslehre;2805;1461;4266
WS 2011/12;SF094;Wasserbau;49;31;80
WS 2011/12;SF077;Wasserwirtschaft;189;129;318
WS 2011/12;SF227;Weinbau und Kellerwirtschaft;139;80;219
WS 2011/12;SF201;Werken (technisch)/Technologie;21;22;43
WS 2011/12;SF176;Werkerziehung;3;9;12
WS 2011/12;SF177;Werkstofftechnik;1118;327;1445
WS 2011/12;SF130;Westslawisch (allgemein und a.n.g.);3;16;19
WS 2011/12;SF178;Wirtschafts-/Sozialgeografie;2;3;5
WS 2011/12;SF183;Wirtschafts-/Sozialgeschichte;7;7;14
WS 2011/12;SF277;Wirtschaftsinformatik;7049;1815;8864
WS 2011/12;SF370;Wirtschaftsingenieurw. m. ingenieurwiss.Schwerpkt.;8006;1939;9945
WS 2011/12;SF179;Wirtschaftsingenieurw.m.wirtschaftswiss.Schwerpkt.;6093;1895;7988
WS 2011/12;SF276;Wirtschaftsmathematik;1258;807;2065
WS 2011/12;SF181;Wirtschaftspädagogik;415;802;1217
WS 2011/12;SF042;Wirtschaftsrecht;1470;1885;3355
WS 2011/12;SF184;Wirtschaftswissenschaften;7390;6156;13546
WS 2011/12;SF185;Zahnmedizin;520;953;1473
WS 2011/12;SF269;Zoll- und Steuerverwaltung;574;634;1208
WS 2012/13;SF141;Abfallwirtschaft;3;6;9
WS 2012/13;SF002;Afrikanistik;136;196;332
WS 2012/13;SF138;Agrarbiologie;53;56;109
WS 2012/13;SF125;Agrarökonomie;140;139;279
WS 2012/13;SF003;Agrarwissenschaft/Landwirtschaft;1520;1375;2895
WS 2012/13;SF001;Ägyptologie;21;43;64
WS 2012/13;SF152;Allg. Sprachwissenschaft/Indogermanistik;263;993;1256
WS 2012/13;SF188;Allgemeine Literaturwissenschaft;151;533;684
WS 2012/13;SF272;Alte Geschichte;10;10;20
WS 2012/13;SF006;Amerikanistik/Amerikakunde;148;454;602
WS 2012/13;SF007;Angewandte Kunst;252;401;653
WS 2012/13;SF284;Angewandte Sprachwissenschaft;181;941;1122
WS 2012/13;SF140;Angewandte Systemwissenschaften;229;60;289
WS 2012/13;SF008;Anglistik/Englisch;1822;5554;7376
WS 2012/13;SF009;Anthropologie (Humanbiologie);34;81;115
WS 2012/13;SF010;Arabisch/Arabistik;38;70;108
WS 2012/13;SF011;Arbeitslehre/Wirtschaftslehre;84;146;230
WS 2012/13;SF257;Arbeits- und Berufsberatung;6;39;45
WS 2012/13;SF258;Arbeitsverwaltung;32;141;173
WS 2012/13;SF012;Archäologie;329;491;820
WS 2012/13;SF390;Archäometrie (Ingenieurarchäologie);3;2;5
WS 2012/13;SF013;Architektur;2625;3899;6524
WS 2012/13;SF255;Archivwesen;12;20;32
WS 2012/13;SF187;Asiatische Sprachen u.Kulturen/Asienwissenschaften;96;243;339
WS 2012/13;SF014;Astronomie, Astrophysik;18;11;29
WS 2012/13;SF143;Augenoptik;44;126;170
WS 2012/13;SF117;Ausländerpädagogik;3;10;13
WS 2012/13;SF015;Außereurop. Sprachen und Kult. in Ozeanien und Am.;6;25;31
WS 2012/13;SF259;Auswärtige Angelegenheiten;12;20;32
WS 2012/13;SF016;Baltistik;3;2;5
WS 2012/13;SF265;Bankwesen;52;39;91
WS 2012/13;SF017;Bauingenieurwesen/Ingenieurbau;6881;2864;9745
WS 2012/13;SF020;Bergbau/Bergtechnik;266;38;304
WS 2012/13;SF018;Berufsbezogene Fremdsprachenausbildung;120;329;449
WS 2012/13;SF270;Berufs- und Wirtschaftspädagogik;158;89;247
WS 2012/13;SF021;Betriebswirtschaftslehre;19329;20767;40096
WS 2012/13;SF262;Bibliothekswesen;1;4;5
WS 2012/13;SF022;Bibliothekswiss., -wesen (nicht an Verw.-FH);87;382;469
WS 2012/13;SF023;Bildende Kunst/Grafik;208;337;545
WS 2012/13;SF205;Bildhauerei/Plastik;30;48;78
WS 2012/13;SF025;Biochemie;622;757;1379
WS 2012/13;SF283;Biogeographie (ab 2012 ohne SF385);75;131;206
WS 2012/13;SF221;Bioinformatik;231;148;379
WS 2012/13;SF026;Biologie;2956;5282;8238
WS 2012/13;SF300;Biomedizin;68;135;203
WS 2012/13;SF282;Biotechnologie;945;1165;2110
WS 2012/13;SF027;Blinden-/Sehbehindertenpädagogik(ab 2016 zu SF190);-;2;2
WS 2012/13;SF028;Brauwesen/Getränketechnologie;145;36;181
WS 2012/13;SF260;Bundeswehrverwaltung;15;12;27
WS 2012/13;SF031;Byzantinistik;2;2;4
WS 2012/13;SF162;Caritaswissenschaft;3;6;9
WS 2012/13;SF032;Chemie;4225;2858;7083
WS 2012/13;SF033;Chemie-Ingenieurwesen/Chemietechnik;1084;730;1814
WS 2012/13;SF160;Computerlinguistik;102;104;206
WS 2012/13;SF200;Computer- und Kommunikationstechniken;437;257;694
WS 2012/13;SF034;Dänisch;7;8;15
WS 2012/13;SF035;Darstellende Kunst/Bühnenkunst/Regie;86;168;254
WS 2012/13;SF271;Deutsch als Fremdsprache oder als Zweitsprache;88;480;568
WS 2012/13;SF161;Diakoniewissenschaft;15;14;29
WS 2012/13;SF192;Dirigieren;30;18;48
WS 2012/13;SF037;Dokumentationswissenschaft;20;65;85
WS 2012/13;SF231;Druck- und Reproduktionstechnik;264;191;455
WS 2012/13;SF159;Edelstein- und Schmuckdesign;8;26;34
WS 2012/13;SF316;Elektronische Energietechnik;545;64;609
WS 2012/13;SF048;Elektrotechnik/Elektronik;11816;1470;13286
WS 2012/13;SF211;Energietechnik (ohne Elektrotechnik);1493;354;1847
WS 2012/13;SF320;Ernährungswissenschaft;61;429;490
WS 2012/13;SF321;Erwachsenenbildung und außerschulische Jugendbild.;50;154;204
WS 2012/13;SF051;Erziehungsschwierigenpädagogik (ab 2016 zu SF190);31;186;217
WS 2012/13;SF052;Erziehungswissenschaft (Pädagogik);1547;6931;8478
WS 2012/13;SF169;Ethik;14;49;63
WS 2012/13;SF173;Ethnologie;156;587;743
WS 2012/13;SF024;Europäische Ethnologie und Kulturwissenschaft;120;461;581
WS 2012/13;SF167;Europäische Wirtschaft;151;285;436
WS 2012/13;SF544;Ev. Religionspädagogik, kirchliche Bildungsarbeit;49;103;152
WS 2012/13;SF053;Evangelische Theologie, - Religionslehre;440;750;1190
WS 2012/13;SF464;Facility Management;227;192;419
WS 2012/13;SF235;Fahrzeugtechnik;2293;171;2464
WS 2012/13;SF212;Feinwerktechnik;136;7;143
WS 2012/13;SF202;Fertigungs-/Produktionstechnik;1287;155;1442
WS 2012/13;SF054;Film und Fernsehen;182;174;356
WS 2012/13;SF266;Finanzverwaltung;185;289;474
WS 2012/13;SF056;Finno-Ugristik;7;21;28
WS 2012/13;SF058;Forstwissenschaft, -wirtschaft;732;402;1134
WS 2012/13;SF059;Französisch;177;1179;1356
WS 2012/13;SF019;Friesisch (2007 aufgelöst);-;-;-
WS 2012/13;SF060;Gartenbau;194;154;348
WS 2012/13;SF062;Gehörlosen-/Schwerhörigenpäd. (ab 2016 zu SF190);3;81;84
WS 2012/13;SF063;Geistigbeh./Prakt.-Bildb.-Pädag.(ab 2016 zu SF190);17;122;139
WS 2012/13;SF050;Geografie/Erdkunde;1446;1507;2953
WS 2012/13;SF065;Geologie/Paläontologie;56;28;84
WS 2012/13;SF385;Geoökologie;51;71;122
WS 2012/13;SF066;Geophysik;227;201;428
WS 2012/13;SF039;Geowissenschaften;1236;741;1977
WS 2012/13;SF067;Germanistik/Deutsch;2828;10426;13254
WS 2012/13;SF230;Gesang;78;124;202
WS 2012/13;SF068;Geschichte;2393;1994;4387
WS 2012/13;SF275;Geschichte der Mathematik und Naturwissenschaft;6;12;18
WS 2012/13;SF195;Gesundheitspädagogik;64;444;508
WS 2012/13;SF215;Gesundheitstechnik;1056;993;2049
WS 2012/13;SF232;Gesundheitswissenschaften/-management;1212;3277;4489
WS 2012/13;SF216;Glastechnik/Keramik;28;12;40
WS 2012/13;SF069;Grafikdesign/Kommunikationsgestaltung;1026;1611;2637
WS 2012/13;SF070;Griechisch;26;53;79
WS 2012/13;SF115;Grundschul-/Primärstufenpädagogik;74;460;534
WS 2012/13;SF071;Haushalts- und Ernährungswissenschaft;237;1071;1308
WS 2012/13;SF333;Haushaltswissenschaft;2;30;32
WS 2012/13;SF073;Hebräisch/Judaistik;32;77;109
WS 2012/13;SF082;Holz-/Fasertechnik;257;38;295
WS 2012/13;SF197;Holzbau;154;33;187
WS 2012/13;SF075;Holzwirtschaft;46;13;59
WS 2012/13;SF076;Hütten- und Gießereiwesen;107;37;144
WS 2012/13;SF078;Indologie;9;25;34
WS 2012/13;SF203;Industriedesign/Produktgestaltung;295;296;591
WS 2012/13;SF079;Informatik;11191;2014;13205
WS 2012/13;SF123;Ingenieurinformatik/Technische Informatik;1553;262;1815
WS 2012/13;SF242;Innenarchitektur;76;494;570
WS 2012/13;SF261;Innere Verwaltung;317;497;814
WS 2012/13;SF080;Instrumentalmusik;541;629;1170
WS 2012/13;SF072;Interdisz. Studien (Schwerp. Ingenieurwissensch.);2135;729;2864
WS 2012/13;SF049;Interdisz. Studien (Schwerp. Naturwissenschaften);317;354;671
WS 2012/13;SF030;Interdisz.Studien(Schwerp.Rechts-,Wirt.-u.Sozialw);754;1201;1955
WS 2012/13;SF004;Interdisz.Studien (Schwerpkt.Sprach-u.Kulturwiss.);847;2855;3702
WS 2012/13;SF040;Interdisz. Studien (Schwerpunkt Kunst, Kunstwiss.);44;131;175
WS 2012/13;SF182;Internationale Betriebswirtschaft/Management;3404;5064;8468
WS 2012/13;SF081;Iranistik;6;17;23
WS 2012/13;SF292;Islamische Studien;-;-;-
WS 2012/13;SF083;Islamwissenschaft;103;229;332
WS 2012/13;SF084;Italienisch;43;235;278
WS 2012/13;SF085;Japanologie;167;344;511
WS 2012/13;SF164;Jazz und Popularmusik;142;41;183
WS 2012/13;SF252;Journalistik (ab 2008 zu SF303);-;-;-
WS 2012/13;SF168;Justizvollzug;20;24;44
WS 2012/13;SF280;Kartografie;82;65;147
WS 2012/13;SF545;Kath. Religionspäd., kirchliche Bildungsarbeit;26;44;70
WS 2012/13;SF086;Katholische Theologie, - Religionslehre;342;461;803
WS 2012/13;SF180;Kaukasistik;-;1;1
WS 2012/13;SF241;Kerntechnik/Kernverfahrenstechnik;1;1;2
WS 2012/13;SF193;Kirchenmusik;42;15;57
WS 2012/13;SF005;Klassische Philologie;66;109;175
WS 2012/13;SF222;Kommunikations- und Informationstechnik;1260;221;1481
WS 2012/13;SF303;Kommunikationswissenschaft/Publizistik;854;2151;3005
WS 2012/13;SF191;Komposition;43;22;65
WS 2012/13;SF087;Körperbehindertenpädagogik (ab 2016 zu SF190);11;48;59
WS 2012/13;SF047;Krankenpflege-Ausbildung (ab 2004 zu SF234);-;-;-
WS 2012/13;SF091;Kunsterziehung;124;522;646
WS 2012/13;SF092;Kunstgeschichte, Kunstwissenschaft;273;1486;1759
WS 2012/13;SF219;Kunststofftechnik;215;41;256
WS 2012/13;SF093;Landespflege/Landschaftsgestaltung;367;491;858
WS 2012/13;SF095;Latein;208;346;554
WS 2012/13;SF038;Lateinamerika;12;54;66
WS 2012/13;SF096;Lebensmittelchemie;111;329;440
WS 2012/13;SF097;Lebensmitteltechnologie;398;477;875
WS 2012/13;SF099;Lernbehindertenpädagogik (ab 2016 zu SF190);41;237;278
WS 2012/13;SF154;Lernbereich Gesellschaftslehre;9;14;23
WS 2012/13;SF186;Lernbereich Naturwissenschaft/Sachunterricht;29;191;220
WS 2012/13;SF090;Lernbereich Sprach- und Kulturwissenschaften;81;551;632
WS 2012/13;SF199;Lernbereich Technik;77;37;114
WS 2012/13;SF057;Luft- und Raumfahrttechnik;987;122;1109
WS 2012/13;SF204;Malerei;44;55;99
WS 2012/13;SF198;Managem.im Gesundh.-u.Sozialber.(ab 2004 zu SF232);-;-;-
WS 2012/13;SF103;Markscheidewesen;3;3;6
WS 2012/13;SF104;Maschinenbau/-wesen;18801;2313;21114
WS 2012/13;SF294;Materialwissenschaften;-;-;-
WS 2012/13;SF105;Mathematik;4729;5152;9881
WS 2012/13;SF237;Mathematische Statistik/Wahrscheinlichkeitsrechn.;113;110;223
WS 2012/13;SF380;Mechatronik;3019;274;3293
WS 2012/13;SF121;Medieninformatik;1684;879;2563
WS 2012/13;SF133;Medienk./Komm.-/Infowissenschaft (ab 08 zu SF303);-;-;-
WS 2012/13;SF305;Medientechnik;675;445;1120
WS 2012/13;SF304;Medienwirtschaft/Medienmanagement;512;922;1434
WS 2012/13;SF302;Medienwissenschaft;506;1365;1871
WS 2012/13;SF107;Medizin (Allgemein-Medizin);3659;5918;9577
WS 2012/13;SF247;Medizinische Informatik;304;267;571
WS 2012/13;SF061;Meliorationswesen;-;-;-
WS 2012/13;SF108;Metalltechnik;100;12;112
WS 2012/13;SF110;Meteorologie;210;149;359
WS 2012/13;SF157;Mikroelektronik;19;4;23
WS 2012/13;SF286;Mikrosystemtechnik;405;84;489
WS 2012/13;SF220;Milch- und Molkereiwirtschaft;8;9;17
WS 2012/13;SF111;Mineralogie;4;3;7
WS 2012/13;SF273;Mittlere und neuere Geschichte;8;13;21
WS 2012/13;SF113;Musikerziehung;368;513;881
WS 2012/13;SF114;Musikwissenschaft/-geschichte;401;490;891
WS 2012/13;SF064;Naturschutz;63;72;135
WS 2012/13;SF223;Nautik/Seefahrt;201;35;236
WS 2012/13;SF287;Neue Medien;99;124;223
WS 2012/13;SF043;Neugriechisch;4;12;16
WS 2012/13;SF233;Nichtärztliche Heilberufe/Therapien;326;1420;1746
WS 2012/13;SF189;Niederdeutsch;-;-;-
WS 2012/13;SF119;Niederländisch;32;91;123
WS 2012/13;SF120;Nordistik/Skandinavist.(Nord.Phil.,Einzelsp.a.n.g);65;175;240
WS 2012/13;SF088;Optoelektronik;103;38;141
WS 2012/13;SF165;Orchestermusik;149;178;327
WS 2012/13;SF122;Orientalistik, Altorientalistik;81;141;222
WS 2012/13;SF044;Ost- und Südosteuropa;39;117;156
WS 2012/13;SF124;Ozeanografie;4;2;6
WS 2012/13;SF365;Pädagogik der frühen Kindheit;44;335;379
WS 2012/13;SF353;Pflanzenproduktion;33;21;54
WS 2012/13;SF234;Pflegewissenschaft/-management;399;1351;1750
WS 2012/13;SF126;Pharmazie;621;1445;2066
WS 2012/13;SF127;Philosophie;1361;1107;2468
WS 2012/13;SF128;Physik;4996;1544;6540
WS 2012/13;SF224;Physikalische Technik;582;153;735
WS 2012/13;SF129;Politikwissenschaft/Politologie;2391;2167;4558
WS 2012/13;SF263;Polizei/Verfassungsschutz;2018;1076;3094
WS 2012/13;SF206;Polnisch;15;35;50
WS 2012/13;SF131;Portugiesisch;5;14;19
WS 2012/13;SF132;Psychologie;1720;6122;7842
WS 2012/13;SF109;Publizistik (ab 2008 zu SF303);-;-;-
WS 2012/13;SF134;Raumplanung;340;399;739
WS 2012/13;SF256;Rechtspflege;116;474;590
WS 2012/13;SF135;Rechtswissenschaft;6194;9344;15538
WS 2012/13;SF310;Regenerative Energien;130;41;171
WS 2012/13;SF136;Religionswissenschaft;84;131;215
WS 2012/13;SF101;Restaurierungskunde;29;124;153
WS 2012/13;SF163;Rhythmik;1;6;7
WS 2012/13;SF137;Romanistik (Roman.Philologie,Einzelsprach. a.n.g.);209;960;1169
WS 2012/13;SF139;Russisch;42;113;155
WS 2012/13;SF254;Sachunterricht (einschließlich Schulgarten);3;13;16
WS 2012/13;SF102;Schauspiel;47;37;84
WS 2012/13;SF142;Schiffbau/Schiffstechnik;207;29;236
WS 2012/13;SF361;Schulpädagogik;16;25;41
WS 2012/13;SF145;Sinologie/Koreanistik;149;365;514
WS 2012/13;SF146;Slawistik (Slawische Philologie);71;256;327
WS 2012/13;SF190;Sonderpädagogik;120;822;942
WS 2012/13;SF290;Sonstige Fächer;465;529;994
WS 2012/13;SF036;Sonstige Regionalwissenschaften;58;116;174
WS 2012/13;SF207;Sorbisch;-;5;5
WS 2012/13;SF208;Soziale Arbeit;1214;4780;5994
WS 2012/13;SF147;Sozialkunde;155;182;337
WS 2012/13;SF046;Sozialmed./Öff. Gesundheitsw. (ab 2004 zu SF232);-;-;-
WS 2012/13;SF245;Sozialpädagogik;153;948;1101
WS 2012/13;SF264;Sozialversicherung;167;381;548
WS 2012/13;SF253;Sozialwesen;831;3611;4442
WS 2012/13;SF148;Sozialwissenschaft;1379;2150;3529
WS 2012/13;SF149;Soziologie;981;2053;3034
WS 2012/13;SF150;Spanisch;232;951;1183
WS 2012/13;SF166;Sportmanagement/Sportökonomie;373;153;526
WS 2012/13;SF098;Sportpädagogik/Sportpsychologie;870;724;1594
WS 2012/13;SF029;Sportwissenschaft;1138;858;1996
WS 2012/13;SF151;Sprachheilpädagogik/Logopädie (ab 2016 zu SF190);12;197;209
WS 2012/13;SF429;Stahlbau;1;-;1
WS 2012/13;SF196;Studienkolleg;-;-;-
WS 2012/13;SF153;Südslawisch(Bulgarisch,Serbokroatisch,Slowen.usw.);3;3;6
WS 2012/13;SF106;Tanzpädagogik;32;67;99
WS 2012/13;SF144;Technische Kybernetik;82;22;104
WS 2012/13;SF118;Technomathematik;283;99;382
WS 2012/13;SF116;Textilgestaltung;71;571;642
WS 2012/13;SF225;Textil- und Bekleidungstechnik/-gewerbe;82;465;547
WS 2012/13;SF155;Theaterwissenschaft;144;446;590
WS 2012/13;SF156;Tiermedizin/Veterinärmedizin;133;877;1010
WS 2012/13;SF371;Tierproduktion;2;3;5
WS 2012/13;SF194;Tonmeister;32;3;35
WS 2012/13;SF274;Tourismuswirtschaft;346;1569;1915
WS 2012/13;SF074;Transport-/Fördertechnik;56;7;63
WS 2012/13;SF209;Tschechisch;2;25;27
WS 2012/13;SF158;Turkologie;15;77;92
WS 2012/13;SF458;Umweltschutz;242;191;433
WS 2012/13;SF457;Umwelttechnik (einschließlich Recycling);1070;539;1609
WS 2012/13;SF548;Ur- und Frühgeschichte;20;14;34
WS 2012/13;SF226;Verfahrenstechnik;1313;744;2057
WS 2012/13;SF170;Verhaltensgestörtenpädagogik (ab 2016 zu SF190);20;83;103
WS 2012/13;SF089;Verkehrsingenieurwesen;588;189;777
WS 2012/13;SF268;Verkehrswesen;-;-;-
WS 2012/13;SF210;Verkehrswirtschaft;181;110;291
WS 2012/13;SF171;Vermessungswesen (Geodäsie);663;287;950
WS 2012/13;SF213;Versorgungstechnik;736;111;847
WS 2012/13;SF172;Verwaltungswissenschaft/-wesen;1158;1724;2882
WS 2012/13;SF174;Volkskunde;52;231;283
WS 2012/13;SF175;Volkswirtschaftslehre;2479;1412;3891
WS 2012/13;SF094;Wasserbau;50;27;77
WS 2012/13;SF077;Wasserwirtschaft;185;131;316
WS 2012/13;SF227;Weinbau und Kellerwirtschaft;146;71;217
WS 2012/13;SF201;Werken (technisch)/Technologie;22;30;52
WS 2012/13;SF176;Werkerziehung;4;14;18
WS 2012/13;SF177;Werkstofftechnik;922;329;1251
WS 2012/13;SF130;Westslawisch (allgemein und a.n.g.);4;17;21
WS 2012/13;SF178;Wirtschafts-/Sozialgeografie;-;4;4
WS 2012/13;SF183;Wirtschafts-/Sozialgeschichte;5;4;9
WS 2012/13;SF277;Wirtschaftsinformatik;6838;1947;8785
WS 2012/13;SF370;Wirtschaftsingenieurw. m. ingenieurwiss.Schwerpkt.;7220;2136;9356
WS 2012/13;SF179;Wirtschaftsingenieurw.m.wirtschaftswiss.Schwerpkt.;5372;1925;7297
WS 2012/13;SF276;Wirtschaftsmathematik;1026;676;1702
WS 2012/13;SF181;Wirtschaftspädagogik;353;683;1036
WS 2012/13;SF042;Wirtschaftsrecht;1282;1855;3137
WS 2012/13;SF184;Wirtschaftswissenschaften;7076;6665;13741
WS 2012/13;SF185;Zahnmedizin;497;956;1453
WS 2012/13;SF269;Zoll- und Steuerverwaltung;560;786;1346
WS 2013/14;SF141;Abfallwirtschaft;10;10;20
WS 2013/14;SF002;Afrikanistik;128;199;327
WS 2013/14;SF138;Agrarbiologie;49;62;111
WS 2013/14;SF125;Agrarökonomie;166;107;273
WS 2013/14;SF003;Agrarwissenschaft/Landwirtschaft;1586;1422;3008
WS 2013/14;SF001;Ägyptologie;22;50;72
WS 2013/14;SF152;Allg. Sprachwissenschaft/Indogermanistik;224;888;1112
WS 2013/14;SF188;Allgemeine Literaturwissenschaft;122;518;640
WS 2013/14;SF272;Alte Geschichte;16;9;25
WS 2013/14;SF006;Amerikanistik/Amerikakunde;183;495;678
WS 2013/14;SF007;Angewandte Kunst;229;463;692
WS 2013/14;SF284;Angewandte Sprachwissenschaft;219;1007;1226
WS 2013/14;SF140;Angewandte Systemwissenschaften;230;59;289
WS 2013/14;SF008;Anglistik/Englisch;1805;5651;7456
WS 2013/14;SF009;Anthropologie (Humanbiologie);45;98;143
WS 2013/14;SF010;Arabisch/Arabistik;45;68;113
WS 2013/14;SF011;Arbeitslehre/Wirtschaftslehre;98;133;231
WS 2013/14;SF257;Arbeits- und Berufsberatung;8;41;49
WS 2013/14;SF258;Arbeitsverwaltung;50;126;176
WS 2013/14;SF012;Archäologie;327;443;770
WS 2013/14;SF390;Archäometrie (Ingenieurarchäologie);1;-;1
WS 2013/14;SF013;Architektur;2614;3844;6458
WS 2013/14;SF255;Archivwesen;22;35;57
WS 2013/14;SF187;Asiatische Sprachen u.Kulturen/Asienwissenschaften;91;215;306
WS 2013/14;SF014;Astronomie, Astrophysik;24;15;39
WS 2013/14;SF143;Augenoptik;34;103;137
WS 2013/14;SF117;Ausländerpädagogik;11;18;29
WS 2013/14;SF015;Außereurop. Sprachen und Kult. in Ozeanien und Am.;9;25;34
WS 2013/14;SF259;Auswärtige Angelegenheiten;11;32;43
WS 2013/14;SF016;Baltistik;2;-;2
WS 2013/14;SF265;Bankwesen;46;45;91
WS 2013/14;SF017;Bauingenieurwesen/Ingenieurbau;7112;2851;9963
WS 2013/14;SF020;Bergbau/Bergtechnik;233;47;280
WS 2013/14;SF018;Berufsbezogene Fremdsprachenausbildung;114;412;526
WS 2013/14;SF270;Berufs- und Wirtschaftspädagogik;138;105;243
WS 2013/14;SF021;Betriebswirtschaftslehre;19470;20805;40275
WS 2013/14;SF262;Bibliothekswesen;1;2;3
WS 2013/14;SF022;Bibliothekswiss., -wesen (nicht an Verw.-FH);103;397;500
WS 2013/14;SF023;Bildende Kunst/Grafik;223;295;518
WS 2013/14;SF205;Bildhauerei/Plastik;32;63;95
WS 2013/14;SF025;Biochemie;583;822;1405
WS 2013/14;SF283;Biogeographie (ab 2012 ohne SF385);61;133;194
WS 2013/14;SF221;Bioinformatik;217;150;367
WS 2013/14;SF026;Biologie;2986;5514;8500
WS 2013/14;SF300;Biomedizin;89;141;230
WS 2013/14;SF282;Biotechnologie;1013;1202;2215
WS 2013/14;SF027;Blinden-/Sehbehindertenpädagogik(ab 2016 zu SF190);-;-;-
WS 2013/14;SF028;Brauwesen/Getränketechnologie;148;35;183
WS 2013/14;SF260;Bundeswehrverwaltung;27;27;54
WS 2013/14;SF031;Byzantinistik;2;-;2
WS 2013/14;SF162;Caritaswissenschaft;8;4;12
WS 2013/14;SF032;Chemie;4297;2980;7277
WS 2013/14;SF033;Chemie-Ingenieurwesen/Chemietechnik;1193;697;1890
WS 2013/14;SF160;Computerlinguistik;120;109;229
WS 2013/14;SF200;Computer- und Kommunikationstechniken;438;225;663
WS 2013/14;SF034;Dänisch;2;9;11
WS 2013/14;SF035;Darstellende Kunst/Bühnenkunst/Regie;91;183;274
WS 2013/14;SF271;Deutsch als Fremdsprache oder als Zweitsprache;111;416;527
WS 2013/14;SF161;Diakoniewissenschaft;16;39;55
WS 2013/14;SF192;Dirigieren;26;18;44
WS 2013/14;SF037;Dokumentationswissenschaft;21;45;66
WS 2013/14;SF231;Druck- und Reproduktionstechnik;209;222;431
WS 2013/14;SF159;Edelstein- und Schmuckdesign;1;26;27
WS 2013/14;SF316;Elektronische Energietechnik;532;108;640
WS 2013/14;SF048;Elektrotechnik/Elektronik;11654;1489;13143
WS 2013/14;SF211;Energietechnik (ohne Elektrotechnik);1309;369;1678
WS 2013/14;SF320;Ernährungswissenschaft;62;434;496
WS 2013/14;SF321;Erwachsenenbildung und außerschulische Jugendbild.;26;124;150
WS 2013/14;SF051;Erziehungsschwierigenpädagogik (ab 2016 zu SF190);29;186;215
WS 2013/14;SF052;Erziehungswissenschaft (Pädagogik);1482;7627;9109
WS 2013/14;SF169;Ethik;18;49;67
WS 2013/14;SF173;Ethnologie;179;662;841
WS 2013/14;SF024;Europäische Ethnologie und Kulturwissenschaft;157;516;673
WS 2013/14;SF167;Europäische Wirtschaft;125;211;336
WS 2013/14;SF544;Ev. Religionspädagogik, kirchliche Bildungsarbeit;47;128;175
WS 2013/14;SF053;Evangelische Theologie, - Religionslehre;493;718;1211
WS 2013/14;SF464;Facility Management;291;211;502
WS 2013/14;SF235;Fahrzeugtechnik;1976;160;2136
WS 2013/14;SF212;Feinwerktechnik;146;11;157
WS 2013/14;SF202;Fertigungs-/Produktionstechnik;1202;176;1378
WS 2013/14;SF054;Film und Fernsehen;203;166;369
WS 2013/14;SF266;Finanzverwaltung;195;271;466
WS 2013/14;SF056;Finno-Ugristik;6;26;32
WS 2013/14;SF058;Forstwissenschaft, -wirtschaft;719;391;1110
WS 2013/14;SF059;Französisch;161;1051;1212
WS 2013/14;SF019;Friesisch (2007 aufgelöst);-;-;-
WS 2013/14;SF060;Gartenbau;204;169;373
WS 2013/14;SF062;Gehörlosen-/Schwerhörigenpäd. (ab 2016 zu SF190);6;74;80
WS 2013/14;SF063;Geistigbeh./Prakt.-Bildb.-Pädag.(ab 2016 zu SF190);20;144;164
WS 2013/14;SF050;Geografie/Erdkunde;1594;1724;3318
WS 2013/14;SF065;Geologie/Paläontologie;52;25;77
WS 2013/14;SF385;Geoökologie;61;95;156
WS 2013/14;SF066;Geophysik;151;95;246
WS 2013/14;SF039;Geowissenschaften;1246;836;2082
WS 2013/14;SF067;Germanistik/Deutsch;2592;10590;13182
WS 2013/14;SF230;Gesang;71;108;179
WS 2013/14;SF068;Geschichte;2526;2163;4689
WS 2013/14;SF275;Geschichte der Mathematik und Naturwissenschaft;4;6;10
WS 2013/14;SF195;Gesundheitspädagogik;59;453;512
WS 2013/14;SF215;Gesundheitstechnik;1108;991;2099
WS 2013/14;SF232;Gesundheitswissenschaften/-management;1307;3437;4744
WS 2013/14;SF216;Glastechnik/Keramik;36;10;46
WS 2013/14;SF069;Grafikdesign/Kommunikationsgestaltung;919;1721;2640
WS 2013/14;SF070;Griechisch;30;63;93
WS 2013/14;SF115;Grundschul-/Primärstufenpädagogik;72;550;622
WS 2013/14;SF071;Haushalts- und Ernährungswissenschaft;256;1221;1477
WS 2013/14;SF333;Haushaltswissenschaft;17;69;86
WS 2013/14;SF073;Hebräisch/Judaistik;29;47;76
WS 2013/14;SF082;Holz-/Fasertechnik;212;31;243
WS 2013/14;SF197;Holzbau;139;27;166
WS 2013/14;SF075;Holzwirtschaft;47;18;65
WS 2013/14;SF076;Hütten- und Gießereiwesen;134;40;174
WS 2013/14;SF078;Indologie;13;16;29
WS 2013/14;SF203;Industriedesign/Produktgestaltung;261;312;573
WS 2013/14;SF079;Informatik;11772;2279;14051
WS 2013/14;SF123;Ingenieurinformatik/Technische Informatik;1626;245;1871
WS 2013/14;SF242;Innenarchitektur;59;498;557
WS 2013/14;SF261;Innere Verwaltung;302;488;790
WS 2013/14;SF080;Instrumentalmusik;552;598;1150
WS 2013/14;SF072;Interdisz. Studien (Schwerp. Ingenieurwissensch.);2407;1017;3424
WS 2013/14;SF049;Interdisz. Studien (Schwerp. Naturwissenschaften);394;414;808
WS 2013/14;SF030;Interdisz.Studien(Schwerp.Rechts-,Wirt.-u.Sozialw);799;1215;2014
WS 2013/14;SF004;Interdisz.Studien (Schwerpkt.Sprach-u.Kulturwiss.);847;2798;3645
WS 2013/14;SF040;Interdisz. Studien (Schwerpunkt Kunst, Kunstwiss.);45;176;221
WS 2013/14;SF182;Internationale Betriebswirtschaft/Management;3817;5557;9374
WS 2013/14;SF081;Iranistik;10;18;28
WS 2013/14;SF292;Islamische Studien;-;-;-
WS 2013/14;SF083;Islamwissenschaft;126;294;420
WS 2013/14;SF084;Italienisch;61;230;291
WS 2013/14;SF085;Japanologie;221;378;599
WS 2013/14;SF164;Jazz und Popularmusik;188;56;244
WS 2013/14;SF252;Journalistik (ab 2008 zu SF303);-;-;-
WS 2013/14;SF168;Justizvollzug;16;14;30
WS 2013/14;SF280;Kartografie;68;64;132
WS 2013/14;SF545;Kath. Religionspäd., kirchliche Bildungsarbeit;35;53;88
WS 2013/14;SF086;Katholische Theologie, - Religionslehre;278;450;728
WS 2013/14;SF180;Kaukasistik;-;-;-
WS 2013/14;SF241;Kerntechnik/Kernverfahrenstechnik;-;-;-
WS 2013/14;SF193;Kirchenmusik;39;19;58
WS 2013/14;SF005;Klassische Philologie;22;45;67
WS 2013/14;SF222;Kommunikations- und Informationstechnik;1370;250;1620
WS 2013/14;SF303;Kommunikationswissenschaft/Publizistik;796;2113;2909
WS 2013/14;SF191;Komposition;47;18;65
WS 2013/14;SF087;Körperbehindertenpädagogik (ab 2016 zu SF190);9;60;69
WS 2013/14;SF047;Krankenpflege-Ausbildung (ab 2004 zu SF234);-;-;-
WS 2013/14;SF091;Kunsterziehung;124;463;587
WS 2013/14;SF092;Kunstgeschichte, Kunstwissenschaft;258;1392;1650
WS 2013/14;SF219;Kunststofftechnik;205;36;241
WS 2013/14;SF093;Landespflege/Landschaftsgestaltung;401;526;927
WS 2013/14;SF095;Latein;193;303;496
WS 2013/14;SF038;Lateinamerika;21;57;78
WS 2013/14;SF096;Lebensmittelchemie;120;371;491
WS 2013/14;SF097;Lebensmitteltechnologie;446;539;985
WS 2013/14;SF099;Lernbehindertenpädagogik (ab 2016 zu SF190);39;310;349
WS 2013/14;SF154;Lernbereich Gesellschaftslehre;10;10;20
WS 2013/14;SF186;Lernbereich Naturwissenschaft/Sachunterricht;35;164;199
WS 2013/14;SF090;Lernbereich Sprach- und Kulturwissenschaften;72;554;626
WS 2013/14;SF199;Lernbereich Technik;62;43;105
WS 2013/14;SF057;Luft- und Raumfahrttechnik;1015;137;1152
WS 2013/14;SF204;Malerei;41;53;94
WS 2013/14;SF198;Managem.im Gesundh.-u.Sozialber.(ab 2004 zu SF232);-;-;-
WS 2013/14;SF103;Markscheidewesen;3;1;4
WS 2013/14;SF104;Maschinenbau/-wesen;18812;2284;21096
WS 2013/14;SF294;Materialwissenschaften;-;-;-
WS 2013/14;SF105;Mathematik;4720;4888;9608
WS 2013/14;SF237;Mathematische Statistik/Wahrscheinlichkeitsrechn.;169;139;308
WS 2013/14;SF380;Mechatronik;3453;307;3760
WS 2013/14;SF121;Medieninformatik;1755;938;2693
WS 2013/14;SF133;Medienk./Komm.-/Infowissenschaft (ab 08 zu SF303);-;-;-
WS 2013/14;SF305;Medientechnik;782;605;1387
WS 2013/14;SF304;Medienwirtschaft/Medienmanagement;474;958;1432
WS 2013/14;SF302;Medienwissenschaft;495;1538;2033
WS 2013/14;SF107;Medizin (Allgemein-Medizin);3609;5949;9558
WS 2013/14;SF247;Medizinische Informatik;249;252;501
WS 2013/14;SF061;Meliorationswesen;-;-;-
WS 2013/14;SF108;Metalltechnik;101;18;119
WS 2013/14;SF110;Meteorologie;150;115;265
WS 2013/14;SF157;Mikroelektronik;13;9;22
WS 2013/14;SF286;Mikrosystemtechnik;578;104;682
WS 2013/14;SF220;Milch- und Molkereiwirtschaft;6;13;19
WS 2013/14;SF111;Mineralogie;7;2;9
WS 2013/14;SF273;Mittlere und neuere Geschichte;15;6;21
WS 2013/14;SF113;Musikerziehung;329;541;870
WS 2013/14;SF114;Musikwissenschaft/-geschichte;397;471;868
WS 2013/14;SF064;Naturschutz;53;75;128
WS 2013/14;SF223;Nautik/Seefahrt;172;39;211
WS 2013/14;SF287;Neue Medien;120;129;249
WS 2013/14;SF043;Neugriechisch;5;8;13
WS 2013/14;SF233;Nichtärztliche Heilberufe/Therapien;319;1454;1773
WS 2013/14;SF189;Niederdeutsch;1;-;1
WS 2013/14;SF119;Niederländisch;22;45;67
WS 2013/14;SF120;Nordistik/Skandinavist.(Nord.Phil.,Einzelsp.a.n.g);54;214;268
WS 2013/14;SF088;Optoelektronik;98;38;136
WS 2013/14;SF165;Orchestermusik;135;160;295
WS 2013/14;SF122;Orientalistik, Altorientalistik;104;197;301
WS 2013/14;SF044;Ost- und Südosteuropa;37;78;115
WS 2013/14;SF124;Ozeanografie;6;4;10
WS 2013/14;SF365;Pädagogik der frühen Kindheit;26;272;298
WS 2013/14;SF353;Pflanzenproduktion;31;27;58
WS 2013/14;SF234;Pflegewissenschaft/-management;389;1586;1975
WS 2013/14;SF126;Pharmazie;595;1418;2013
WS 2013/14;SF127;Philosophie;1374;1141;2515
WS 2013/14;SF128;Physik;5272;1643;6915
WS 2013/14;SF224;Physikalische Technik;660;160;820
WS 2013/14;SF129;Politikwissenschaft/Politologie;2462;2230;4692
WS 2013/14;SF263;Polizei/Verfassungsschutz;1956;1271;3227
WS 2013/14;SF206;Polnisch;3;17;20
WS 2013/14;SF131;Portugiesisch;1;19;20
WS 2013/14;SF132;Psychologie;1916;6860;8776
WS 2013/14;SF109;Publizistik (ab 2008 zu SF303);-;-;-
WS 2013/14;SF134;Raumplanung;343;467;810
WS 2013/14;SF256;Rechtspflege;229;357;586
WS 2013/14;SF135;Rechtswissenschaft;6842;9977;16819
WS 2013/14;SF310;Regenerative Energien;126;34;160
WS 2013/14;SF136;Religionswissenschaft;71;143;214
WS 2013/14;SF101;Restaurierungskunde;23;111;134
WS 2013/14;SF163;Rhythmik;-;3;3
WS 2013/14;SF137;Romanistik (Roman.Philologie,Einzelsprach. a.n.g.);189;792;981
WS 2013/14;SF139;Russisch;50;152;202
WS 2013/14;SF254;Sachunterricht (einschließlich Schulgarten);5;16;21
WS 2013/14;SF102;Schauspiel;41;33;74
WS 2013/14;SF142;Schiffbau/Schiffstechnik;163;32;195
WS 2013/14;SF361;Schulpädagogik;14;39;53
WS 2013/14;SF145;Sinologie/Koreanistik;159;339;498
WS 2013/14;SF146;Slawistik (Slawische Philologie);86;270;356
WS 2013/14;SF190;Sonderpädagogik;132;780;912
WS 2013/14;SF290;Sonstige Fächer;499;608;1107
WS 2013/14;SF036;Sonstige Regionalwissenschaften;42;95;137
WS 2013/14;SF207;Sorbisch;6;7;13
WS 2013/14;SF208;Soziale Arbeit;1199;4854;6053
WS 2013/14;SF147;Sozialkunde;194;199;393
WS 2013/14;SF046;Sozialmed./Öff. Gesundheitsw. (ab 2004 zu SF232);-;-;-
WS 2013/14;SF245;Sozialpädagogik;214;1111;1325
WS 2013/14;SF264;Sozialversicherung;163;372;535
WS 2013/14;SF253;Sozialwesen;812;3393;4205
WS 2013/14;SF148;Sozialwissenschaft;1451;2297;3748
WS 2013/14;SF149;Soziologie;860;1904;2764
WS 2013/14;SF150;Spanisch;247;845;1092
WS 2013/14;SF166;Sportmanagement/Sportökonomie;376;184;560
WS 2013/14;SF098;Sportpädagogik/Sportpsychologie;822;732;1554
WS 2013/14;SF029;Sportwissenschaft;1230;851;2081
WS 2013/14;SF151;Sprachheilpädagogik/Logopädie (ab 2016 zu SF190);11;190;201
WS 2013/14;SF429;Stahlbau;-;-;-
WS 2013/14;SF196;Studienkolleg;-;-;-
WS 2013/14;SF153;Südslawisch(Bulgarisch,Serbokroatisch,Slowen.usw.);2;7;9
WS 2013/14;SF106;Tanzpädagogik;22;58;80
WS 2013/14;SF144;Technische Kybernetik;78;26;104
WS 2013/14;SF118;Technomathematik;292;95;387
WS 2013/14;SF116;Textilgestaltung;75;566;641
WS 2013/14;SF225;Textil- und Bekleidungstechnik/-gewerbe;66;483;549
WS 2013/14;SF155;Theaterwissenschaft;105;446;551
WS 2013/14;SF156;Tiermedizin/Veterinärmedizin;163;854;1017
WS 2013/14;SF371;Tierproduktion;6;4;10
WS 2013/14;SF194;Tonmeister;71;6;77
WS 2013/14;SF274;Tourismuswirtschaft;376;1574;1950
WS 2013/14;SF074;Transport-/Fördertechnik;73;7;80
WS 2013/14;SF209;Tschechisch;-;2;2
WS 2013/14;SF158;Turkologie;16;50;66
WS 2013/14;SF458;Umweltschutz;242;216;458
WS 2013/14;SF457;Umwelttechnik (einschließlich Recycling);1040;569;1609
WS 2013/14;SF548;Ur- und Frühgeschichte;8;22;30
WS 2013/14;SF226;Verfahrenstechnik;1312;713;2025
WS 2013/14;SF170;Verhaltensgestörtenpädagogik (ab 2016 zu SF190);9;74;83
WS 2013/14;SF089;Verkehrsingenieurwesen;663;246;909
WS 2013/14;SF268;Verkehrswesen;-;-;-
WS 2013/14;SF210;Verkehrswirtschaft;225;106;331
WS 2013/14;SF171;Vermessungswesen (Geodäsie);827;394;1221
WS 2013/14;SF213;Versorgungstechnik;684;130;814
WS 2013/14;SF172;Verwaltungswissenschaft/-wesen;1248;1779;3027
WS 2013/14;SF174;Volkskunde;59;258;317
WS 2013/14;SF175;Volkswirtschaftslehre;2705;1765;4470
WS 2013/14;SF094;Wasserbau;164;114;278
WS 2013/14;SF077;Wasserwirtschaft;193;154;347
WS 2013/14;SF227;Weinbau und Kellerwirtschaft;149;66;215
WS 2013/14;SF201;Werken (technisch)/Technologie;9;15;24
WS 2013/14;SF176;Werkerziehung;-;12;12
WS 2013/14;SF177;Werkstofftechnik;1001;360;1361
WS 2013/14;SF130;Westslawisch (allgemein und a.n.g.);6;25;31
WS 2013/14;SF178;Wirtschafts-/Sozialgeografie;2;4;6
WS 2013/14;SF183;Wirtschafts-/Sozialgeschichte;7;4;11
WS 2013/14;SF277;Wirtschaftsinformatik;6846;1885;8731
WS 2013/14;SF370;Wirtschaftsingenieurw. m. ingenieurwiss.Schwerpkt.;7730;2252;9982
WS 2013/14;SF179;Wirtschaftsingenieurw.m.wirtschaftswiss.Schwerpkt.;5138;1899;7037
WS 2013/14;SF276;Wirtschaftsmathematik;993;682;1675
WS 2013/14;SF181;Wirtschaftspädagogik;345;718;1063
WS 2013/14;SF042;Wirtschaftsrecht;1223;1750;2973
WS 2013/14;SF184;Wirtschaftswissenschaften;7427;7050;14477
WS 2013/14;SF185;Zahnmedizin;491;999;1490
WS 2013/14;SF269;Zoll- und Steuerverwaltung;514;715;1229
WS 2014/15;SF141;Abfallwirtschaft;14;11;25
WS 2014/15;SF002;Afrikanistik;117;142;259
WS 2014/15;SF138;Agrarbiologie;45;46;91
WS 2014/15;SF125;Agrarökonomie;167;142;309
WS 2014/15;SF003;Agrarwissenschaft/Landwirtschaft;1439;1475;2914
WS 2014/15;SF001;Ägyptologie;31;60;91
WS 2014/15;SF152;Allg. Sprachwissenschaft/Indogermanistik;249;966;1215
WS 2014/15;SF188;Allgemeine Literaturwissenschaft;118;477;595
WS 2014/15;SF272;Alte Geschichte;19;12;31
WS 2014/15;SF006;Amerikanistik/Amerikakunde;165;439;604
WS 2014/15;SF007;Angewandte Kunst;204;406;610
WS 2014/15;SF284;Angewandte Sprachwissenschaft;151;843;994
WS 2014/15;SF140;Angewandte Systemwissenschaften;208;57;265
WS 2014/15;SF008;Anglistik/Englisch;1714;5050;6764
WS 2014/15;SF009;Anthropologie (Humanbiologie);22;48;70
WS 2014/15;SF010;Arabisch/Arabistik;39;77;116
WS 2014/15;SF011;Arbeitslehre/Wirtschaftslehre;91;171;262
WS 2014/15;SF257;Arbeits- und Berufsberatung;7;43;50
WS 2014/15;SF258;Arbeitsverwaltung;58;182;240
WS 2014/15;SF012;Archäologie;316;391;707
WS 2014/15;SF390;Archäometrie (Ingenieurarchäologie);1;-;1
WS 2014/15;SF013;Architektur;2589;4014;6603
WS 2014/15;SF255;Archivwesen;12;24;36
WS 2014/15;SF187;Asiatische Sprachen u.Kulturen/Asienwissenschaften;98;230;328
WS 2014/15;SF014;Astronomie, Astrophysik;18;12;30
WS 2014/15;SF143;Augenoptik;42;98;140
WS 2014/15;SF117;Ausländerpädagogik;4;9;13
WS 2014/15;SF015;Außereurop. Sprachen und Kult. in Ozeanien und Am.;12;18;30
WS 2014/15;SF259;Auswärtige Angelegenheiten;11;32;43
WS 2014/15;SF016;Baltistik;1;1;2
WS 2014/15;SF265;Bankwesen;45;38;83
WS 2014/15;SF017;Bauingenieurwesen/Ingenieurbau;6889;2768;9657
WS 2014/15;SF020;Bergbau/Bergtechnik;211;25;236
WS 2014/15;SF018;Berufsbezogene Fremdsprachenausbildung;112;365;477
WS 2014/15;SF270;Berufs- und Wirtschaftspädagogik;138;115;253
WS 2014/15;SF021;Betriebswirtschaftslehre;20282;20954;41236
WS 2014/15;SF262;Bibliothekswesen;-;3;3
WS 2014/15;SF022;Bibliothekswiss., -wesen (nicht an Verw.-FH);94;355;449
WS 2014/15;SF023;Bildende Kunst/Grafik;182;283;465
WS 2014/15;SF205;Bildhauerei/Plastik;36;59;95
WS 2014/15;SF025;Biochemie;616;784;1400
WS 2014/15;SF283;Biogeographie (ab 2012 ohne SF385);86;135;221
WS 2014/15;SF221;Bioinformatik;209;155;364
WS 2014/15;SF026;Biologie;2795;5361;8156
WS 2014/15;SF300;Biomedizin;89;149;238
WS 2014/15;SF282;Biotechnologie;1014;1316;2330
WS 2014/15;SF027;Blinden-/Sehbehindertenpädagogik(ab 2016 zu SF190);-;-;-
WS 2014/15;SF028;Brauwesen/Getränketechnologie;124;31;155
WS 2014/15;SF260;Bundeswehrverwaltung;28;31;59
WS 2014/15;SF031;Byzantinistik;4;4;8
WS 2014/15;SF162;Caritaswissenschaft;4;5;9
WS 2014/15;SF032;Chemie;4107;2793;6900
WS 2014/15;SF033;Chemie-Ingenieurwesen/Chemietechnik;1152;700;1852
WS 2014/15;SF160;Computerlinguistik;106;114;220
WS 2014/15;SF200;Computer- und Kommunikationstechniken;519;320;839
WS 2014/15;SF034;Dänisch;1;7;8
WS 2014/15;SF035;Darstellende Kunst/Bühnenkunst/Regie;77;199;276
WS 2014/15;SF271;Deutsch als Fremdsprache oder als Zweitsprache;79;383;462
WS 2014/15;SF161;Diakoniewissenschaft;20;57;77
WS 2014/15;SF192;Dirigieren;18;14;32
WS 2014/15;SF037;Dokumentationswissenschaft;17;43;60
WS 2014/15;SF231;Druck- und Reproduktionstechnik;179;197;376
WS 2014/15;SF159;Edelstein- und Schmuckdesign;3;23;26
WS 2014/15;SF316;Elektronische Energietechnik;460;108;568
WS 2014/15;SF048;Elektrotechnik/Elektronik;10618;1534;12152
WS 2014/15;SF211;Energietechnik (ohne Elektrotechnik);1141;296;1437
WS 2014/15;SF320;Ernährungswissenschaft;81;404;485
WS 2014/15;SF321;Erwachsenenbildung und außerschulische Jugendbild.;30;130;160
WS 2014/15;SF051;Erziehungsschwierigenpädagogik (ab 2016 zu SF190);46;269;315
WS 2014/15;SF052;Erziehungswissenschaft (Pädagogik);1459;7664;9123
WS 2014/15;SF169;Ethik;22;79;101
WS 2014/15;SF173;Ethnologie;162;602;764
WS 2014/15;SF024;Europäische Ethnologie und Kulturwissenschaft;155;451;606
WS 2014/15;SF167;Europäische Wirtschaft;200;415;615
WS 2014/15;SF544;Ev. Religionspädagogik, kirchliche Bildungsarbeit;48;121;169
WS 2014/15;SF053;Evangelische Theologie, - Religionslehre;463;704;1167
WS 2014/15;SF464;Facility Management;245;232;477
WS 2014/15;SF235;Fahrzeugtechnik;2035;169;2204
WS 2014/15;SF212;Feinwerktechnik;109;8;117
WS 2014/15;SF202;Fertigungs-/Produktionstechnik;1008;186;1194
WS 2014/15;SF054;Film und Fernsehen;190;180;370
WS 2014/15;SF266;Finanzverwaltung;208;271;479
WS 2014/15;SF056;Finno-Ugristik;7;21;28
WS 2014/15;SF058;Forstwissenschaft, -wirtschaft;689;388;1077
WS 2014/15;SF059;Französisch;180;907;1087
WS 2014/15;SF019;Friesisch (2007 aufgelöst);-;-;-
WS 2014/15;SF060;Gartenbau;166;148;314
WS 2014/15;SF062;Gehörlosen-/Schwerhörigenpäd. (ab 2016 zu SF190);6;73;79
WS 2014/15;SF063;Geistigbeh./Prakt.-Bildb.-Pädag.(ab 2016 zu SF190);24;144;168
WS 2014/15;SF050;Geografie/Erdkunde;1518;1605;3123
WS 2014/15;SF065;Geologie/Paläontologie;43;27;70
WS 2014/15;SF385;Geoökologie;60;99;159
WS 2014/15;SF066;Geophysik;146;103;249
WS 2014/15;SF039;Geowissenschaften;1074;704;1778
WS 2014/15;SF067;Germanistik/Deutsch;2529;9874;12403
WS 2014/15;SF230;Gesang;63;116;179
WS 2014/15;SF068;Geschichte;2357;1948;4305
WS 2014/15;SF275;Geschichte der Mathematik und Naturwissenschaft;4;7;11
WS 2014/15;SF195;Gesundheitspädagogik;59;401;460
WS 2014/15;SF215;Gesundheitstechnik;1055;1039;2094
WS 2014/15;SF232;Gesundheitswissenschaften/-management;1383;3793;5176
WS 2014/15;SF216;Glastechnik/Keramik;24;16;40
WS 2014/15;SF069;Grafikdesign/Kommunikationsgestaltung;951;1707;2658
WS 2014/15;SF070;Griechisch;48;54;102
WS 2014/15;SF115;Grundschul-/Primärstufenpädagogik;67;594;661
WS 2014/15;SF071;Haushalts- und Ernährungswissenschaft;275;1283;1558
WS 2014/15;SF333;Haushaltswissenschaft;11;31;42
WS 2014/15;SF073;Hebräisch/Judaistik;17;49;66
WS 2014/15;SF082;Holz-/Fasertechnik;205;34;239
WS 2014/15;SF197;Holzbau;170;24;194
WS 2014/15;SF075;Holzwirtschaft;56;12;68
WS 2014/15;SF076;Hütten- und Gießereiwesen;132;62;194
WS 2014/15;SF078;Indologie;11;13;24
WS 2014/15;SF203;Industriedesign/Produktgestaltung;275;352;627
WS 2014/15;SF079;Informatik;12218;2435;14653
WS 2014/15;SF123;Ingenieurinformatik/Technische Informatik;1623;235;1858
WS 2014/15;SF242;Innenarchitektur;74;500;574
WS 2014/15;SF261;Innere Verwaltung;315;548;863
WS 2014/15;SF080;Instrumentalmusik;536;602;1138
WS 2014/15;SF072;Interdisz. Studien (Schwerp. Ingenieurwissensch.);2156;814;2970
WS 2014/15;SF049;Interdisz. Studien (Schwerp. Naturwissenschaften);414;440;854
WS 2014/15;SF030;Interdisz.Studien(Schwerp.Rechts-,Wirt.-u.Sozialw);738;1115;1853
WS 2014/15;SF004;Interdisz.Studien (Schwerpkt.Sprach-u.Kulturwiss.);863;2762;3625
WS 2014/15;SF040;Interdisz. Studien (Schwerpunkt Kunst, Kunstwiss.);57;178;235
WS 2014/15;SF182;Internationale Betriebswirtschaft/Management;3771;5494;9265
WS 2014/15;SF081;Iranistik;17;19;36
WS 2014/15;SF292;Islamische Studien;-;-;-
WS 2014/15;SF083;Islamwissenschaft;115;252;367
WS 2014/15;SF084;Italienisch;39;227;266
WS 2014/15;SF085;Japanologie;237;318;555
WS 2014/15;SF164;Jazz und Popularmusik;163;60;223
WS 2014/15;SF252;Journalistik (ab 2008 zu SF303);-;-;-
WS 2014/15;SF168;Justizvollzug;16;11;27
WS 2014/15;SF280;Kartografie;52;31;83
WS 2014/15;SF545;Kath. Religionspäd., kirchliche Bildungsarbeit;22;79;101
WS 2014/15;SF086;Katholische Theologie, - Religionslehre;275;384;659
WS 2014/15;SF180;Kaukasistik;-;-;-
WS 2014/15;SF241;Kerntechnik/Kernverfahrenstechnik;1;-;1
WS 2014/15;SF193;Kirchenmusik;38;24;62
WS 2014/15;SF005;Klassische Philologie;18;43;61
WS 2014/15;SF222;Kommunikations- und Informationstechnik;1162;257;1419
WS 2014/15;SF303;Kommunikationswissenschaft/Publizistik;766;2166;2932
WS 2014/15;SF191;Komposition;51;19;70
WS 2014/15;SF087;Körperbehindertenpädagogik (ab 2016 zu SF190);7;49;56
WS 2014/15;SF047;Krankenpflege-Ausbildung (ab 2004 zu SF234);-;-;-
WS 2014/15;SF091;Kunsterziehung;95;487;582
WS 2014/15;SF092;Kunstgeschichte, Kunstwissenschaft;309;1327;1636
WS 2014/15;SF219;Kunststofftechnik;256;51;307
WS 2014/15;SF093;Landespflege/Landschaftsgestaltung;363;539;902
WS 2014/15;SF095;Latein;163;260;423
WS 2014/15;SF038;Lateinamerika;18;51;69
WS 2014/15;SF096;Lebensmittelchemie;130;345;475
WS 2014/15;SF097;Lebensmitteltechnologie;395;501;896
WS 2014/15;SF099;Lernbehindertenpädagogik (ab 2016 zu SF190);33;274;307
WS 2014/15;SF154;Lernbereich Gesellschaftslehre;8;10;18
WS 2014/15;SF186;Lernbereich Naturwissenschaft/Sachunterricht;38;230;268
WS 2014/15;SF090;Lernbereich Sprach- und Kulturwissenschaften;69;510;579
WS 2014/15;SF199;Lernbereich Technik;89;46;135
WS 2014/15;SF057;Luft- und Raumfahrttechnik;1030;143;1173
WS 2014/15;SF204;Malerei;40;57;97
WS 2014/15;SF198;Managem.im Gesundh.-u.Sozialber.(ab 2004 zu SF232);-;-;-
WS 2014/15;SF103;Markscheidewesen;1;1;2
WS 2014/15;SF104;Maschinenbau/-wesen;18223;2394;20617
WS 2014/15;SF294;Materialwissenschaften;-;-;-
WS 2014/15;SF105;Mathematik;4342;4516;8858
WS 2014/15;SF237;Mathematische Statistik/Wahrscheinlichkeitsrechn.;120;164;284
WS 2014/15;SF380;Mechatronik;3031;277;3308
WS 2014/15;SF121;Medieninformatik;1892;1029;2921
WS 2014/15;SF133;Medienk./Komm.-/Infowissenschaft (ab 08 zu SF303);-;-;-
WS 2014/15;SF305;Medientechnik;833;706;1539
WS 2014/15;SF304;Medienwirtschaft/Medienmanagement;462;958;1420
WS 2014/15;SF302;Medienwissenschaft;533;1467;2000
WS 2014/15;SF107;Medizin (Allgemein-Medizin);3521;5802;9323
WS 2014/15;SF247;Medizinische Informatik;243;239;482
WS 2014/15;SF061;Meliorationswesen;-;-;-
WS 2014/15;SF108;Metalltechnik;104;29;133
WS 2014/15;SF110;Meteorologie;168;142;310
WS 2014/15;SF157;Mikroelektronik;37;7;44
WS 2014/15;SF286;Mikrosystemtechnik;547;112;659
WS 2014/15;SF220;Milch- und Molkereiwirtschaft;14;12;26
WS 2014/15;SF111;Mineralogie;10;5;15
WS 2014/15;SF273;Mittlere und neuere Geschichte;7;15;22
WS 2014/15;SF113;Musikerziehung;298;493;791
WS 2014/15;SF114;Musikwissenschaft/-geschichte;410;484;894
WS 2014/15;SF064;Naturschutz;69;91;160
WS 2014/15;SF223;Nautik/Seefahrt;148;27;175
WS 2014/15;SF287;Neue Medien;83;125;208
WS 2014/15;SF043;Neugriechisch;3;11;14
WS 2014/15;SF233;Nichtärztliche Heilberufe/Therapien;391;1485;1876
WS 2014/15;SF189;Niederdeutsch;-;-;-
WS 2014/15;SF119;Niederländisch;25;70;95
WS 2014/15;SF120;Nordistik/Skandinavist.(Nord.Phil.,Einzelsp.a.n.g);61;204;265
WS 2014/15;SF088;Optoelektronik;86;42;128
WS 2014/15;SF165;Orchestermusik;145;190;335
WS 2014/15;SF122;Orientalistik, Altorientalistik;114;177;291
WS 2014/15;SF044;Ost- und Südosteuropa;29;78;107
WS 2014/15;SF124;Ozeanografie;5;2;7
WS 2014/15;SF365;Pädagogik der frühen Kindheit;41;314;355
WS 2014/15;SF353;Pflanzenproduktion;42;32;74
WS 2014/15;SF234;Pflegewissenschaft/-management;388;1600;1988
WS 2014/15;SF126;Pharmazie;590;1470;2060
WS 2014/15;SF127;Philosophie;1300;1221;2521
WS 2014/15;SF128;Physik;4971;1641;6612
WS 2014/15;SF224;Physikalische Technik;649;188;837
WS 2014/15;SF129;Politikwissenschaft/Politologie;2380;2263;4643
WS 2014/15;SF263;Polizei/Verfassungsschutz;2267;1145;3412
WS 2014/15;SF206;Polnisch;2;23;25
WS 2014/15;SF131;Portugiesisch;1;18;19
WS 2014/15;SF132;Psychologie;2182;6965;9147
WS 2014/15;SF109;Publizistik (ab 2008 zu SF303);-;-;-
WS 2014/15;SF134;Raumplanung;348;449;797
WS 2014/15;SF256;Rechtspflege;125;426;551
WS 2014/15;SF135;Rechtswissenschaft;6557;9788;16345
WS 2014/15;SF310;Regenerative Energien;130;33;163
WS 2014/15;SF136;Religionswissenschaft;74;163;237
WS 2014/15;SF101;Restaurierungskunde;22;111;133
WS 2014/15;SF163;Rhythmik;-;8;8
WS 2014/15;SF137;Romanistik (Roman.Philologie,Einzelsprach. a.n.g.);181;810;991
WS 2014/15;SF139;Russisch;38;121;159
WS 2014/15;SF254;Sachunterricht (einschließlich Schulgarten);2;16;18
WS 2014/15;SF102;Schauspiel;45;29;74
WS 2014/15;SF142;Schiffbau/Schiffstechnik;190;31;221
WS 2014/15;SF361;Schulpädagogik;31;54;85
WS 2014/15;SF145;Sinologie/Koreanistik;163;323;486
WS 2014/15;SF146;Slawistik (Slawische Philologie);67;202;269
WS 2014/15;SF190;Sonderpädagogik;138;906;1044
WS 2014/15;SF290;Sonstige Fächer;540;726;1266
WS 2014/15;SF036;Sonstige Regionalwissenschaften;50;81;131
WS 2014/15;SF207;Sorbisch;-;5;5
WS 2014/15;SF208;Soziale Arbeit;1364;5084;6448
WS 2014/15;SF147;Sozialkunde;136;149;285
WS 2014/15;SF046;Sozialmed./Öff. Gesundheitsw. (ab 2004 zu SF232);-;-;-
WS 2014/15;SF245;Sozialpädagogik;237;1289;1526
WS 2014/15;SF264;Sozialversicherung;163;334;497
WS 2014/15;SF253;Sozialwesen;822;3680;4502
WS 2014/15;SF148;Sozialwissenschaft;1226;2115;3341
WS 2014/15;SF149;Soziologie;901;1950;2851
WS 2014/15;SF150;Spanisch;220;756;976
WS 2014/15;SF166;Sportmanagement/Sportökonomie;377;216;593
WS 2014/15;SF098;Sportpädagogik/Sportpsychologie;616;483;1099
WS 2014/15;SF029;Sportwissenschaft;1387;908;2295
WS 2014/15;SF151;Sprachheilpädagogik/Logopädie (ab 2016 zu SF190);10;198;208
WS 2014/15;SF429;Stahlbau;-;-;-
WS 2014/15;SF196;Studienkolleg;-;-;-
WS 2014/15;SF153;Südslawisch(Bulgarisch,Serbokroatisch,Slowen.usw.);2;3;5
WS 2014/15;SF106;Tanzpädagogik;18;60;78
WS 2014/15;SF144;Technische Kybernetik;92;25;117
WS 2014/15;SF118;Technomathematik;215;85;300
WS 2014/15;SF116;Textilgestaltung;57;516;573
WS 2014/15;SF225;Textil- und Bekleidungstechnik/-gewerbe;110;526;636
WS 2014/15;SF155;Theaterwissenschaft;101;445;546
WS 2014/15;SF156;Tiermedizin/Veterinärmedizin;164;859;1023
WS 2014/15;SF371;Tierproduktion;8;8;16
WS 2014/15;SF194;Tonmeister;77;16;93
WS 2014/15;SF274;Tourismuswirtschaft;360;1510;1870
WS 2014/15;SF074;Transport-/Fördertechnik;48;1;49
WS 2014/15;SF209;Tschechisch;-;3;3
WS 2014/15;SF158;Turkologie;34;114;148
WS 2014/15;SF458;Umweltschutz;232;240;472
WS 2014/15;SF457;Umwelttechnik (einschließlich Recycling);976;547;1523
WS 2014/15;SF548;Ur- und Frühgeschichte;22;26;48
WS 2014/15;SF226;Verfahrenstechnik;1266;756;2022
WS 2014/15;SF170;Verhaltensgestörtenpädagogik (ab 2016 zu SF190);14;77;91
WS 2014/15;SF089;Verkehrsingenieurwesen;691;250;941
WS 2014/15;SF268;Verkehrswesen;-;-;-
WS 2014/15;SF210;Verkehrswirtschaft;200;107;307
WS 2014/15;SF171;Vermessungswesen (Geodäsie);760;371;1131
WS 2014/15;SF213;Versorgungstechnik;665;99;764
WS 2014/15;SF172;Verwaltungswissenschaft/-wesen;1238;1813;3051
WS 2014/15;SF174;Volkskunde;50;223;273
WS 2014/15;SF175;Volkswirtschaftslehre;2398;1441;3839
WS 2014/15;SF094;Wasserbau;159;106;265
WS 2014/15;SF077;Wasserwirtschaft;190;108;298
WS 2014/15;SF227;Weinbau und Kellerwirtschaft;138;90;228
WS 2014/15;SF201;Werken (technisch)/Technologie;4;20;24
WS 2014/15;SF176;Werkerziehung;4;15;19
WS 2014/15;SF177;Werkstofftechnik;943;367;1310
WS 2014/15;SF130;Westslawisch (allgemein und a.n.g.);2;15;17
WS 2014/15;SF178;Wirtschafts-/Sozialgeografie;-;4;4
WS 2014/15;SF183;Wirtschafts-/Sozialgeschichte;8;5;13
WS 2014/15;SF277;Wirtschaftsinformatik;7385;2087;9472
WS 2014/15;SF370;Wirtschaftsingenieurw. m. ingenieurwiss.Schwerpkt.;7651;2275;9926
WS 2014/15;SF179;Wirtschaftsingenieurw.m.wirtschaftswiss.Schwerpkt.;4631;1718;6349
WS 2014/15;SF276;Wirtschaftsmathematik;904;642;1546
WS 2014/15;SF181;Wirtschaftspädagogik;369;758;1127
WS 2014/15;SF042;Wirtschaftsrecht;1293;1928;3221
WS 2014/15;SF184;Wirtschaftswissenschaften;7421;6919;14340
WS 2014/15;SF185;Zahnmedizin;488;959;1447
WS 2014/15;SF269;Zoll- und Steuerverwaltung;510;770;1280
WS 2015/16;SF141;Abfallwirtschaft;12;11;23
WS 2015/16;SF002;Afrikanistik;87;139;226
WS 2015/16;SF138;Agrarbiologie;65;76;141
WS 2015/16;SF125;Agrarökonomie;192;152;344
WS 2015/16;SF003;Agrarwissenschaft/Landwirtschaft;1494;1403;2897
WS 2015/16;SF001;Ägyptologie;64;80;144
WS 2015/16;SF152;Allg. Sprachwissenschaft/Indogermanistik;242;977;1219
WS 2015/16;SF188;Allgemeine Literaturwissenschaft;105;497;602
WS 2015/16;SF272;Alte Geschichte;16;12;28
WS 2015/16;SF006;Amerikanistik/Amerikakunde;170;449;619
WS 2015/16;SF007;Angewandte Kunst;210;387;597
WS 2015/16;SF284;Angewandte Sprachwissenschaft;150;900;1050
WS 2015/16;SF140;Angewandte Systemwissenschaften;238;78;316
WS 2015/16;SF008;Anglistik/Englisch;1752;5213;6965
WS 2015/16;SF009;Anthropologie (Humanbiologie);19;56;75
WS 2015/16;SF010;Arabisch/Arabistik;43;88;131
WS 2015/16;SF011;Arbeitslehre/Wirtschaftslehre;64;141;205
WS 2015/16;SF257;Arbeits- und Berufsberatung;14;43;57
WS 2015/16;SF258;Arbeitsverwaltung;56;223;279
WS 2015/16;SF012;Archäologie;329;516;845
WS 2015/16;SF390;Archäometrie (Ingenieurarchäologie);-;1;1
WS 2015/16;SF013;Architektur;2578;3695;6273
WS 2015/16;SF255;Archivwesen;15;24;39
WS 2015/16;SF187;Asiatische Sprachen u.Kulturen/Asienwissenschaften;78;203;281
WS 2015/16;SF014;Astronomie, Astrophysik;23;17;40
WS 2015/16;SF143;Augenoptik;41;98;139
WS 2015/16;SF117;Ausländerpädagogik;5;7;12
WS 2015/16;SF015;Außereurop. Sprachen und Kult. in Ozeanien und Am.;10;25;35
WS 2015/16;SF259;Auswärtige Angelegenheiten;15;41;56
WS 2015/16;SF016;Baltistik;-;1;1
WS 2015/16;SF265;Bankwesen;50;40;90
WS 2015/16;SF017;Bauingenieurwesen/Ingenieurbau;6590;2875;9465
WS 2015/16;SF020;Bergbau/Bergtechnik;188;48;236
WS 2015/16;SF018;Berufsbezogene Fremdsprachenausbildung;113;383;496
WS 2015/16;SF270;Berufs- und Wirtschaftspädagogik;144;88;232
WS 2015/16;SF021;Betriebswirtschaftslehre;18877;19834;38711
WS 2015/16;SF262;Bibliothekswesen;1;6;7
WS 2015/16;SF022;Bibliothekswiss., -wesen (nicht an Verw.-FH);58;319;377
WS 2015/16;SF023;Bildende Kunst/Grafik;213;343;556
WS 2015/16;SF205;Bildhauerei/Plastik;31;37;68
WS 2015/16;SF025;Biochemie;563;846;1409
WS 2015/16;SF283;Biogeographie (ab 2012 ohne SF385);74;96;170
WS 2015/16;SF221;Bioinformatik;214;178;392
WS 2015/16;SF026;Biologie;2786;5289;8075
WS 2015/16;SF300;Biomedizin;102;157;259
WS 2015/16;SF282;Biotechnologie;1005;1411;2416
WS 2015/16;SF027;Blinden-/Sehbehindertenpädagogik(ab 2016 zu SF190);-;-;-
WS 2015/16;SF028;Brauwesen/Getränketechnologie;112;33;145
WS 2015/16;SF260;Bundeswehrverwaltung;20;24;44
WS 2015/16;SF031;Byzantinistik;6;1;7
WS 2015/16;SF162;Caritaswissenschaft;-;2;2
WS 2015/16;SF032;Chemie;4283;2983;7266
WS 2015/16;SF033;Chemie-Ingenieurwesen/Chemietechnik;1041;616;1657
WS 2015/16;SF160;Computerlinguistik;123;108;231
WS 2015/16;SF200;Computer- und Kommunikationstechniken;564;344;908
WS 2015/16;SF034;Dänisch;3;15;18
WS 2015/16;SF035;Darstellende Kunst/Bühnenkunst/Regie;88;183;271
WS 2015/16;SF271;Deutsch als Fremdsprache oder als Zweitsprache;146;578;724
WS 2015/16;SF161;Diakoniewissenschaft;19;31;50
WS 2015/16;SF192;Dirigieren;20;18;38
WS 2015/16;SF037;Dokumentationswissenschaft;20;51;71
WS 2015/16;SF231;Druck- und Reproduktionstechnik;117;163;280
WS 2015/16;SF159;Edelstein- und Schmuckdesign;1;23;24
WS 2015/16;SF316;Elektronische Energietechnik;569;132;701
WS 2015/16;SF048;Elektrotechnik/Elektronik;10102;1600;11702
WS 2015/16;SF211;Energietechnik (ohne Elektrotechnik);1040;296;1336
WS 2015/16;SF320;Ernährungswissenschaft;70;466;536
WS 2015/16;SF321;Erwachsenenbildung und außerschulische Jugendbild.;38;159;197
WS 2015/16;SF051;Erziehungsschwierigenpädagogik (ab 2016 zu SF190);-;-;-
WS 2015/16;SF052;Erziehungswissenschaft (Pädagogik);1645;7199;8844
WS 2015/16;SF169;Ethik;21;63;84
WS 2015/16;SF173;Ethnologie;188;568;756
WS 2015/16;SF024;Europäische Ethnologie und Kulturwissenschaft;116;425;541
WS 2015/16;SF167;Europäische Wirtschaft;205;520;725
WS 2015/16;SF544;Ev. Religionspädagogik, kirchliche Bildungsarbeit;48;116;164
WS 2015/16;SF053;Evangelische Theologie, - Religionslehre;427;680;1107
WS 2015/16;SF464;Facility Management;263;227;490
WS 2015/16;SF235;Fahrzeugtechnik;2033;199;2232
WS 2015/16;SF212;Feinwerktechnik;121;9;130
WS 2015/16;SF202;Fertigungs-/Produktionstechnik;960;167;1127
WS 2015/16;SF054;Film und Fernsehen;228;186;414
WS 2015/16;SF266;Finanzverwaltung;191;279;470
WS 2015/16;SF056;Finno-Ugristik;9;26;35
WS 2015/16;SF058;Forstwissenschaft, -wirtschaft;693;400;1093
WS 2015/16;SF059;Französisch;142;714;856
WS 2015/16;SF019;Friesisch (2007 aufgelöst);-;-;-
WS 2015/16;SF060;Gartenbau;180;167;347
WS 2015/16;SF062;Gehörlosen-/Schwerhörigenpäd. (ab 2016 zu SF190);-;-;-
WS 2015/16;SF063;Geistigbeh./Prakt.-Bildb.-Pädag.(ab 2016 zu SF190);-;-;-
WS 2015/16;SF050;Geografie/Erdkunde;1407;1439;2846
WS 2015/16;SF065;Geologie/Paläontologie;43;29;72
WS 2015/16;SF385;Geoökologie;77;116;193
WS 2015/16;SF066;Geophysik;116;94;210
WS 2015/16;SF039;Geowissenschaften;1101;773;1874
WS 2015/16;SF067;Germanistik/Deutsch;2381;9358;11739
WS 2015/16;SF230;Gesang;69;124;193
WS 2015/16;SF068;Geschichte;2297;2025;4322
WS 2015/16;SF275;Geschichte der Mathematik und Naturwissenschaft;2;1;3
WS 2015/16;SF195;Gesundheitspädagogik;67;413;480
WS 2015/16;SF215;Gesundheitstechnik;1107;1052;2159
WS 2015/16;SF232;Gesundheitswissenschaften/-management;1599;4373;5972
WS 2015/16;SF216;Glastechnik/Keramik;15;3;18
WS 2015/16;SF069;Grafikdesign/Kommunikationsgestaltung;931;1812;2743
WS 2015/16;SF070;Griechisch;27;35;62
WS 2015/16;SF115;Grundschul-/Primärstufenpädagogik;87;562;649
WS 2015/16;SF071;Haushalts- und Ernährungswissenschaft;260;1176;1436
WS 2015/16;SF333;Haushaltswissenschaft;17;38;55
WS 2015/16;SF073;Hebräisch/Judaistik;22;34;56
WS 2015/16;SF082;Holz-/Fasertechnik;213;42;255
WS 2015/16;SF197;Holzbau;139;30;169
WS 2015/16;SF075;Holzwirtschaft;58;20;78
WS 2015/16;SF076;Hütten- und Gießereiwesen;114;45;159
WS 2015/16;SF078;Indologie;17;18;35
WS 2015/16;SF203;Industriedesign/Produktgestaltung;270;314;584
WS 2015/16;SF079;Informatik;13107;2751;15858
WS 2015/16;SF123;Ingenieurinformatik/Technische Informatik;1754;291;2045
WS 2015/16;SF242;Innenarchitektur;71;515;586
WS 2015/16;SF261;Innere Verwaltung;354;588;942
WS 2015/16;SF080;Instrumentalmusik;534;601;1135
WS 2015/16;SF072;Interdisz. Studien (Schwerp. Ingenieurwissensch.);2268;921;3189
WS 2015/16;SF049;Interdisz. Studien (Schwerp. Naturwissenschaften);404;371;775
WS 2015/16;SF030;Interdisz.Studien(Schwerp.Rechts-,Wirt.-u.Sozialw);780;1189;1969
WS 2015/16;SF004;Interdisz.Studien (Schwerpkt.Sprach-u.Kulturwiss.);816;2662;3478
WS 2015/16;SF040;Interdisz. Studien (Schwerpunkt Kunst, Kunstwiss.);82;179;261
WS 2015/16;SF182;Internationale Betriebswirtschaft/Management;3804;5348;9152
WS 2015/16;SF081;Iranistik;8;23;31
WS 2015/16;SF292;Islamische Studien;17;24;41
WS 2015/16;SF083;Islamwissenschaft;106;218;324
WS 2015/16;SF084;Italienisch;51;194;245
WS 2015/16;SF085;Japanologie;243;378;621
WS 2015/16;SF164;Jazz und Popularmusik;150;52;202
WS 2015/16;SF252;Journalistik (ab 2008 zu SF303);-;-;-
WS 2015/16;SF168;Justizvollzug;21;17;38
WS 2015/16;SF280;Kartografie;53;49;102
WS 2015/16;SF545;Kath. Religionspäd., kirchliche Bildungsarbeit;34;77;111
WS 2015/16;SF086;Katholische Theologie, - Religionslehre;268;361;629
WS 2015/16;SF180;Kaukasistik;-;1;1
WS 2015/16;SF241;Kerntechnik/Kernverfahrenstechnik;-;-;-
WS 2015/16;SF193;Kirchenmusik;34;28;62
WS 2015/16;SF005;Klassische Philologie;30;34;64
WS 2015/16;SF222;Kommunikations- und Informationstechnik;1213;269;1482
WS 2015/16;SF303;Kommunikationswissenschaft/Publizistik;748;2139;2887
WS 2015/16;SF191;Komposition;36;26;62
WS 2015/16;SF087;Körperbehindertenpädagogik (ab 2016 zu SF190);-;-;-
WS 2015/16;SF047;Krankenpflege-Ausbildung (ab 2004 zu SF234);-;-;-
WS 2015/16;SF091;Kunsterziehung;105;469;574
WS 2015/16;SF092;Kunstgeschichte, Kunstwissenschaft;293;1331;1624
WS 2015/16;SF219;Kunststofftechnik;228;46;274
WS 2015/16;SF093;Landespflege/Landschaftsgestaltung;367;495;862
WS 2015/16;SF095;Latein;139;196;335
WS 2015/16;SF038;Lateinamerika;20;36;56
WS 2015/16;SF096;Lebensmittelchemie;152;335;487
WS 2015/16;SF097;Lebensmitteltechnologie;370;514;884
WS 2015/16;SF099;Lernbehindertenpädagogik (ab 2016 zu SF190);-;-;-
WS 2015/16;SF154;Lernbereich Gesellschaftslehre;7;16;23
WS 2015/16;SF186;Lernbereich Naturwissenschaft/Sachunterricht;40;232;272
WS 2015/16;SF090;Lernbereich Sprach- und Kulturwissenschaften;63;521;584
WS 2015/16;SF199;Lernbereich Technik;107;68;175
WS 2015/16;SF057;Luft- und Raumfahrttechnik;910;163;1073
WS 2015/16;SF204;Malerei;32;60;92
WS 2015/16;SF198;Managem.im Gesundh.-u.Sozialber.(ab 2004 zu SF232);-;-;-
WS 2015/16;SF103;Markscheidewesen;5;5;10
WS 2015/16;SF104;Maschinenbau/-wesen;17896;2426;20322
WS 2015/16;SF294;Materialwissenschaften;112;50;162
WS 2015/16;SF105;Mathematik;4399;4555;8954
WS 2015/16;SF237;Mathematische Statistik/Wahrscheinlichkeitsrechn.;122;128;250
WS 2015/16;SF380;Mechatronik;3225;343;3568
WS 2015/16;SF121;Medieninformatik;1894;1134;3028
WS 2015/16;SF133;Medienk./Komm.-/Infowissenschaft (ab 08 zu SF303);-;-;-
WS 2015/16;SF305;Medientechnik;707;621;1328
WS 2015/16;SF304;Medienwirtschaft/Medienmanagement;497;900;1397
WS 2015/16;SF302;Medienwissenschaft;522;1437;1959
WS 2015/16;SF107;Medizin (Allgemein-Medizin);3633;6061;9694
WS 2015/16;SF247;Medizinische Informatik;255;250;505
WS 2015/16;SF061;Meliorationswesen;-;-;-
WS 2015/16;SF108;Metalltechnik;114;15;129
WS 2015/16;SF110;Meteorologie;169;116;285
WS 2015/16;SF157;Mikroelektronik;28;2;30
WS 2015/16;SF286;Mikrosystemtechnik;501;96;597
WS 2015/16;SF220;Milch- und Molkereiwirtschaft;9;11;20
WS 2015/16;SF111;Mineralogie;10;6;16
WS 2015/16;SF273;Mittlere und neuere Geschichte;24;16;40
WS 2015/16;SF113;Musikerziehung;309;470;779
WS 2015/16;SF114;Musikwissenschaft/-geschichte;357;430;787
WS 2015/16;SF064;Naturschutz;47;56;103
WS 2015/16;SF223;Nautik/Seefahrt;136;26;162
WS 2015/16;SF287;Neue Medien;131;123;254
WS 2015/16;SF043;Neugriechisch;4;18;22
WS 2015/16;SF233;Nichtärztliche Heilberufe/Therapien;314;1497;1811
WS 2015/16;SF189;Niederdeutsch;-;-;-
WS 2015/16;SF119;Niederländisch;19;68;87
WS 2015/16;SF120;Nordistik/Skandinavist.(Nord.Phil.,Einzelsp.a.n.g);51;187;238
WS 2015/16;SF088;Optoelektronik;108;29;137
WS 2015/16;SF165;Orchestermusik;149;155;304
WS 2015/16;SF122;Orientalistik, Altorientalistik;84;134;218
WS 2015/16;SF044;Ost- und Südosteuropa;38;74;112
WS 2015/16;SF124;Ozeanografie;-;1;1
WS 2015/16;SF365;Pädagogik der frühen Kindheit;41;450;491
WS 2015/16;SF353;Pflanzenproduktion;32;35;67
WS 2015/16;SF234;Pflegewissenschaft/-management;404;1479;1883
WS 2015/16;SF126;Pharmazie;609;1497;2106
WS 2015/16;SF127;Philosophie;1404;1519;2923
WS 2015/16;SF128;Physik;5258;1857;7115
WS 2015/16;SF224;Physikalische Technik;633;184;817
WS 2015/16;SF129;Politikwissenschaft/Politologie;2329;2356;4685
WS 2015/16;SF263;Polizei/Verfassungsschutz;2644;1375;4019
WS 2015/16;SF206;Polnisch;-;13;13
WS 2015/16;SF131;Portugiesisch;6;12;18
WS 2015/16;SF132;Psychologie;2234;7484;9718
WS 2015/16;SF109;Publizistik (ab 2008 zu SF303);-;-;-
WS 2015/16;SF134;Raumplanung;366;431;797
WS 2015/16;SF256;Rechtspflege;142;455;597
WS 2015/16;SF135;Rechtswissenschaft;6704;9865;16569
WS 2015/16;SF310;Regenerative Energien;188;50;238
WS 2015/16;SF136;Religionswissenschaft;74;168;242
WS 2015/16;SF101;Restaurierungskunde;22;107;129
WS 2015/16;SF163;Rhythmik;1;1;2
WS 2015/16;SF137;Romanistik (Roman.Philologie,Einzelsprach. a.n.g.);157;705;862
WS 2015/16;SF139;Russisch;28;138;166
WS 2015/16;SF254;Sachunterricht (einschließlich Schulgarten);1;42;43
WS 2015/16;SF102;Schauspiel;51;34;85
WS 2015/16;SF142;Schiffbau/Schiffstechnik;134;21;155
WS 2015/16;SF361;Schulpädagogik;30;63;93
WS 2015/16;SF145;Sinologie/Koreanistik;153;332;485
WS 2015/16;SF146;Slawistik (Slawische Philologie);60;200;260
WS 2015/16;SF190;Sonderpädagogik;286;1959;2245
WS 2015/16;SF290;Sonstige Fächer;801;945;1746
WS 2015/16;SF036;Sonstige Regionalwissenschaften;49;112;161
WS 2015/16;SF207;Sorbisch;1;6;7
WS 2015/16;SF208;Soziale Arbeit;1308;5540;6848
WS 2015/16;SF147;Sozialkunde;155;144;299
WS 2015/16;SF046;Sozialmed./Öff. Gesundheitsw. (ab 2004 zu SF232);-;-;-
WS 2015/16;SF245;Sozialpädagogik;258;1308;1566
WS 2015/16;SF264;Sozialversicherung;163;326;489
WS 2015/16;SF253;Sozialwesen;767;3215;3982
WS 2015/16;SF148;Sozialwissenschaft;1219;2050;3269
WS 2015/16;SF149;Soziologie;890;2059;2949
WS 2015/16;SF150;Spanisch;183;645;828
WS 2015/16;SF166;Sportmanagement/Sportökonomie;472;179;651
WS 2015/16;SF098;Sportpädagogik/Sportpsychologie;605;512;1117
WS 2015/16;SF029;Sportwissenschaft;1292;921;2213
WS 2015/16;SF151;Sprachheilpädagogik/Logopädie (ab 2016 zu SF190);-;-;-
WS 2015/16;SF429;Stahlbau;-;-;-
WS 2015/16;SF196;Studienkolleg;40;21;61
WS 2015/16;SF153;Südslawisch(Bulgarisch,Serbokroatisch,Slowen.usw.);1;3;4
WS 2015/16;SF106;Tanzpädagogik;20;61;81
WS 2015/16;SF144;Technische Kybernetik;86;22;108
WS 2015/16;SF118;Technomathematik;298;109;407
WS 2015/16;SF116;Textilgestaltung;72;557;629
WS 2015/16;SF225;Textil- und Bekleidungstechnik/-gewerbe;96;419;515
WS 2015/16;SF155;Theaterwissenschaft;108;410;518
WS 2015/16;SF156;Tiermedizin/Veterinärmedizin;139;874;1013
WS 2015/16;SF371;Tierproduktion;1;6;7
WS 2015/16;SF194;Tonmeister;49;11;60
WS 2015/16;SF274;Tourismuswirtschaft;421;1700;2121
WS 2015/16;SF074;Transport-/Fördertechnik;58;6;64
WS 2015/16;SF209;Tschechisch;-;5;5
WS 2015/16;SF158;Turkologie;15;67;82
WS 2015/16;SF458;Umweltschutz;251;259;510
WS 2015/16;SF457;Umwelttechnik (einschließlich Recycling);842;483;1325
WS 2015/16;SF548;Ur- und Frühgeschichte;22;40;62
WS 2015/16;SF226;Verfahrenstechnik;1131;778;1909
WS 2015/16;SF170;Verhaltensgestörtenpädagogik (ab 2016 zu SF190);-;-;-
WS 2015/16;SF089;Verkehrsingenieurwesen;723;242;965
WS 2015/16;SF268;Verkehrswesen;-;-;-
WS 2015/16;SF210;Verkehrswirtschaft;215;106;321
WS 2015/16;SF171;Vermessungswesen (Geodäsie);868;366;1234
WS 2015/16;SF213;Versorgungstechnik;558;105;663
WS 2015/16;SF172;Verwaltungswissenschaft/-wesen;1314;1987;3301
WS 2015/16;SF174;Volkskunde;56;213;269
WS 2015/16;SF175;Volkswirtschaftslehre;2663;1657;4320
WS 2015/16;SF094;Wasserbau;201;116;317
WS 2015/16;SF077;Wasserwirtschaft;206;124;330
WS 2015/16;SF227;Weinbau und Kellerwirtschaft;174;85;259
WS 2015/16;SF201;Werken (technisch)/Technologie;7;21;28
WS 2015/16;SF176;Werkerziehung;-;15;15
WS 2015/16;SF177;Werkstofftechnik;821;380;1201
WS 2015/16;SF130;Westslawisch (allgemein und a.n.g.);1;4;5
WS 2015/16;SF178;Wirtschafts-/Sozialgeografie;-;3;3
WS 2015/16;SF183;Wirtschafts-/Sozialgeschichte;8;7;15
WS 2015/16;SF277;Wirtschaftsinformatik;7162;2036;9198
WS 2015/16;SF370;Wirtschaftsingenieurw. m. ingenieurwiss.Schwerpkt.;7902;2472;10374
WS 2015/16;SF179;Wirtschaftsingenieurw.m.wirtschaftswiss.Schwerpkt.;4200;1626;5826
WS 2015/16;SF276;Wirtschaftsmathematik;890;644;1534
WS 2015/16;SF181;Wirtschaftspädagogik;370;743;1113
WS 2015/16;SF042;Wirtschaftsrecht;1214;1835;3049
WS 2015/16;SF184;Wirtschaftswissenschaften;7022;6398;13420
WS 2015/16;SF185;Zahnmedizin;430;988;1418
WS 2015/16;SF269;Zoll- und Steuerverwaltung;626;856;1482
WS 2016/17;SF141;Abfallwirtschaft;18;3;21
WS 2016/17;SF002;Afrikanistik;88;110;198
WS 2016/17;SF138;Agrarbiologie;58;56;114
WS 2016/17;SF125;Agrarökonomie;192;142;334
WS 2016/17;SF003;Agrarwissenschaft/Landwirtschaft;1351;1326;2677
WS 2016/17;SF001;Ägyptologie;66;89;155
WS 2016/17;SF152;Allg. Sprachwissenschaft/Indogermanistik;218;895;1113
WS 2016/17;SF188;Allgemeine Literaturwissenschaft;104;457;561
WS 2016/17;SF272;Alte Geschichte;11;9;20
WS 2016/17;SF006;Amerikanistik/Amerikakunde;182;414;596
WS 2016/17;SF007;Angewandte Kunst;178;368;546
WS 2016/17;SF284;Angewandte Sprachwissenschaft;144;758;902
WS 2016/17;SF140;Angewandte Systemwissenschaften;301;78;379
WS 2016/17;SF008;Anglistik/Englisch;1912;5552;7464
WS 2016/17;SF009;Anthropologie (Humanbiologie);20;57;77
WS 2016/17;SF010;Arabisch/Arabistik;37;84;121
WS 2016/17;SF011;Arbeitslehre/Wirtschaftslehre;70;162;232
WS 2016/17;SF257;Arbeits- und Berufsberatung;17;74;91
WS 2016/17;SF258;Arbeitsverwaltung;45;197;242
WS 2016/17;SF012;Archäologie;364;481;845
WS 2016/17;SF390;Archäometrie (Ingenieurarchäologie);-;-;-
WS 2016/17;SF013;Architektur;2594;3732;6326
WS 2016/17;SF255;Archivwesen;16;33;49
WS 2016/17;SF187;Asiatische Sprachen u.Kulturen/Asienwissenschaften;108;223;331
WS 2016/17;SF014;Astronomie, Astrophysik;25;18;43
WS 2016/17;SF143;Augenoptik;45;105;150
WS 2016/17;SF117;Ausländerpädagogik;17;11;28
WS 2016/17;SF015;Außereurop. Sprachen und Kult. in Ozeanien und Am.;7;30;37
WS 2016/17;SF259;Auswärtige Angelegenheiten;18;37;55
WS 2016/17;SF016;Baltistik;-;1;1
WS 2016/17;SF265;Bankwesen;52;41;93
WS 2016/17;SF017;Bauingenieurwesen/Ingenieurbau;6683;2799;9482
WS 2016/17;SF020;Bergbau/Bergtechnik;179;36;215
WS 2016/17;SF018;Berufsbezogene Fremdsprachenausbildung;110;342;452
WS 2016/17;SF270;Berufs- und Wirtschaftspädagogik;112;79;191
WS 2016/17;SF021;Betriebswirtschaftslehre;18865;19753;38618
WS 2016/17;SF262;Bibliothekswesen;1;6;7
WS 2016/17;SF022;Bibliothekswiss., -wesen (nicht an Verw.-FH);86;370;456
WS 2016/17;SF023;Bildende Kunst/Grafik;224;341;565
WS 2016/17;SF205;Bildhauerei/Plastik;24;29;53
WS 2016/17;SF025;Biochemie;630;857;1487
WS 2016/17;SF283;Biogeographie (ab 2012 ohne SF385);58;108;166
WS 2016/17;SF221;Bioinformatik;213;167;380
WS 2016/17;SF026;Biologie;2889;5828;8717
WS 2016/17;SF300;Biomedizin;98;216;314
WS 2016/17;SF282;Biotechnologie;984;1292;2276
WS 2016/17;SF027;Blinden-/Sehbehindertenpädagogik(ab 2016 zu SF190);-;-;-
WS 2016/17;SF028;Brauwesen/Getränketechnologie;107;43;150
WS 2016/17;SF260;Bundeswehrverwaltung;31;34;65
WS 2016/17;SF031;Byzantinistik;1;-;1
WS 2016/17;SF162;Caritaswissenschaft;5;2;7
WS 2016/17;SF032;Chemie;4155;3088;7243
WS 2016/17;SF033;Chemie-Ingenieurwesen/Chemietechnik;1067;630;1697
WS 2016/17;SF160;Computerlinguistik;109;131;240
WS 2016/17;SF200;Computer- und Kommunikationstechniken;576;334;910
WS 2016/17;SF034;Dänisch;3;14;17
WS 2016/17;SF035;Darstellende Kunst/Bühnenkunst/Regie;87;184;271
WS 2016/17;SF271;Deutsch als Fremdsprache oder als Zweitsprache;206;703;909
WS 2016/17;SF161;Diakoniewissenschaft;12;39;51
WS 2016/17;SF192;Dirigieren;25;18;43
WS 2016/17;SF037;Dokumentationswissenschaft;20;66;86
WS 2016/17;SF231;Druck- und Reproduktionstechnik;107;182;289
WS 2016/17;SF159;Edelstein- und Schmuckdesign;3;24;27
WS 2016/17;SF316;Elektronische Energietechnik;467;126;593
WS 2016/17;SF048;Elektrotechnik/Elektronik;9910;1680;11590
WS 2016/17;SF211;Energietechnik (ohne Elektrotechnik);937;272;1209
WS 2016/17;SF320;Ernährungswissenschaft;115;557;672
WS 2016/17;SF321;Erwachsenenbildung und außerschulische Jugendbild.;23;128;151
WS 2016/17;SF051;Erziehungsschwierigenpädagogik (ab 2016 zu SF190);-;-;-
WS 2016/17;SF052;Erziehungswissenschaft (Pädagogik);1563;7217;8780
WS 2016/17;SF169;Ethik;23;39;62
WS 2016/17;SF173;Ethnologie;205;597;802
WS 2016/17;SF024;Europäische Ethnologie und Kulturwissenschaft;122;432;554
WS 2016/17;SF167;Europäische Wirtschaft;167;414;581
WS 2016/17;SF544;Ev. Religionspädagogik, kirchliche Bildungsarbeit;38;111;149
WS 2016/17;SF053;Evangelische Theologie, - Religionslehre;440;647;1087
WS 2016/17;SF464;Facility Management;272;260;532
WS 2016/17;SF235;Fahrzeugtechnik;2022;170;2192
WS 2016/17;SF212;Feinwerktechnik;109;12;121
WS 2016/17;SF202;Fertigungs-/Produktionstechnik;996;176;1172
WS 2016/17;SF054;Film und Fernsehen;204;198;402
WS 2016/17;SF266;Finanzverwaltung;186;300;486
WS 2016/17;SF056;Finno-Ugristik;13;22;35
WS 2016/17;SF058;Forstwissenschaft, -wirtschaft;677;413;1090
WS 2016/17;SF059;Französisch;167;762;929
WS 2016/17;SF019;Friesisch (2007 aufgelöst);-;-;-
WS 2016/17;SF060;Gartenbau;187;175;362
WS 2016/17;SF062;Gehörlosen-/Schwerhörigenpäd. (ab 2016 zu SF190);-;-;-
WS 2016/17;SF063;Geistigbeh./Prakt.-Bildb.-Pädag.(ab 2016 zu SF190);-;-;-
WS 2016/17;SF050;Geografie/Erdkunde;1326;1536;2862
WS 2016/17;SF065;Geologie/Paläontologie;75;37;112
WS 2016/17;SF385;Geoökologie;75;118;193
WS 2016/17;SF066;Geophysik;129;95;224
WS 2016/17;SF039;Geowissenschaften;1024;745;1769
WS 2016/17;SF067;Germanistik/Deutsch;2434;9662;12096
WS 2016/17;SF230;Gesang;86;139;225
WS 2016/17;SF068;Geschichte;2382;2017;4399
WS 2016/17;SF275;Geschichte der Mathematik und Naturwissenschaft;5;1;6
WS 2016/17;SF195;Gesundheitspädagogik;96;438;534
WS 2016/17;SF215;Gesundheitstechnik;1099;1036;2135
WS 2016/17;SF232;Gesundheitswissenschaften/-management;1615;4305;5920
WS 2016/17;SF216;Glastechnik/Keramik;24;9;33
WS 2016/17;SF069;Grafikdesign/Kommunikationsgestaltung;949;1881;2830
WS 2016/17;SF070;Griechisch;22;33;55
WS 2016/17;SF115;Grundschul-/Primärstufenpädagogik;116;935;1051
WS 2016/17;SF071;Haushalts- und Ernährungswissenschaft;221;1140;1361
WS 2016/17;SF333;Haushaltswissenschaft;4;33;37
WS 2016/17;SF073;Hebräisch/Judaistik;15;21;36
WS 2016/17;SF082;Holz-/Fasertechnik;195;46;241
WS 2016/17;SF197;Holzbau;145;20;165
WS 2016/17;SF075;Holzwirtschaft;56;16;72
WS 2016/17;SF076;Hütten- und Gießereiwesen;121;46;167
WS 2016/17;SF078;Indologie;6;17;23
WS 2016/17;SF203;Industriedesign/Produktgestaltung;273;300;573
WS 2016/17;SF079;Informatik;14055;3120;17175
WS 2016/17;SF123;Ingenieurinformatik/Technische Informatik;2039;351;2390
WS 2016/17;SF242;Innenarchitektur;79;512;591
WS 2016/17;SF261;Innere Verwaltung;389;740;1129
WS 2016/17;SF080;Instrumentalmusik;515;576;1091
WS 2016/17;SF072;Interdisz. Studien (Schwerp. Ingenieurwissensch.);2207;899;3106
WS 2016/17;SF049;Interdisz. Studien (Schwerp. Naturwissenschaften);614;541;1155
WS 2016/17;SF030;Interdisz.Studien(Schwerp.Rechts-,Wirt.-u.Sozialw);835;1250;2085
WS 2016/17;SF004;Interdisz.Studien (Schwerpkt.Sprach-u.Kulturwiss.);796;2452;3248
WS 2016/17;SF040;Interdisz. Studien (Schwerpunkt Kunst, Kunstwiss.);83;113;196
WS 2016/17;SF182;Internationale Betriebswirtschaft/Management;3912;5330;9242
WS 2016/17;SF081;Iranistik;12;20;32
WS 2016/17;SF292;Islamische Studien;38;104;142
WS 2016/17;SF083;Islamwissenschaft;107;194;301
WS 2016/17;SF084;Italienisch;51;205;256
WS 2016/17;SF085;Japanologie;222;366;588
WS 2016/17;SF164;Jazz und Popularmusik;157;55;212
WS 2016/17;SF252;Journalistik (ab 2008 zu SF303);-;-;-
WS 2016/17;SF168;Justizvollzug;12;19;31
WS 2016/17;SF280;Kartografie;33;28;61
WS 2016/17;SF545;Kath. Religionspäd., kirchliche Bildungsarbeit;21;60;81
WS 2016/17;SF086;Katholische Theologie, - Religionslehre;229;431;660
WS 2016/17;SF180;Kaukasistik;-;1;1
WS 2016/17;SF241;Kerntechnik/Kernverfahrenstechnik;-;-;-
WS 2016/17;SF193;Kirchenmusik;47;23;70
WS 2016/17;SF005;Klassische Philologie;41;42;83
WS 2016/17;SF222;Kommunikations- und Informationstechnik;1137;233;1370
WS 2016/17;SF303;Kommunikationswissenschaft/Publizistik;748;1950;2698
WS 2016/17;SF191;Komposition;43;20;63
WS 2016/17;SF087;Körperbehindertenpädagogik (ab 2016 zu SF190);-;-;-
WS 2016/17;SF047;Krankenpflege-Ausbildung (ab 2004 zu SF234);-;-;-
WS 2016/17;SF091;Kunsterziehung;88;474;562
WS 2016/17;SF092;Kunstgeschichte, Kunstwissenschaft;313;1235;1548
WS 2016/17;SF219;Kunststofftechnik;218;57;275
WS 2016/17;SF093;Landespflege/Landschaftsgestaltung;377;510;887
WS 2016/17;SF095;Latein;132;194;326
WS 2016/17;SF038;Lateinamerika;20;45;65
WS 2016/17;SF096;Lebensmittelchemie;146;438;584
WS 2016/17;SF097;Lebensmitteltechnologie;357;530;887
WS 2016/17;SF099;Lernbehindertenpädagogik (ab 2016 zu SF190);-;-;-
WS 2016/17;SF154;Lernbereich Gesellschaftslehre;13;21;34
WS 2016/17;SF186;Lernbereich Naturwissenschaft/Sachunterricht;50;273;323
WS 2016/17;SF090;Lernbereich Sprach- und Kulturwissenschaften;72;541;613
WS 2016/17;SF199;Lernbereich Technik;86;66;152
WS 2016/17;SF057;Luft- und Raumfahrttechnik;947;138;1085
WS 2016/17;SF204;Malerei;42;73;115
WS 2016/17;SF198;Managem.im Gesundh.-u.Sozialber.(ab 2004 zu SF232);-;-;-
WS 2016/17;SF103;Markscheidewesen;9;10;19
WS 2016/17;SF104;Maschinenbau/-wesen;16781;2364;19145
WS 2016/17;SF294;Materialwissenschaften;293;124;417
WS 2016/17;SF105;Mathematik;4469;4835;9304
WS 2016/17;SF237;Mathematische Statistik/Wahrscheinlichkeitsrechn.;157;154;311
WS 2016/17;SF380;Mechatronik;3164;359;3523
WS 2016/17;SF121;Medieninformatik;1795;1116;2911
WS 2016/17;SF133;Medienk./Komm.-/Infowissenschaft (ab 08 zu SF303);-;-;-
WS 2016/17;SF305;Medientechnik;755;646;1401
WS 2016/17;SF304;Medienwirtschaft/Medienmanagement;514;1008;1522
WS 2016/17;SF302;Medienwissenschaft;472;1378;1850
WS 2016/17;SF107;Medizin (Allgemein-Medizin);3477;6177;9654
WS 2016/17;SF247;Medizinische Informatik;288;263;551
WS 2016/17;SF061;Meliorationswesen;-;-;-
WS 2016/17;SF108;Metalltechnik;128;29;157
WS 2016/17;SF110;Meteorologie;148;132;280
WS 2016/17;SF157;Mikroelektronik;27;5;32
WS 2016/17;SF286;Mikrosystemtechnik;419;83;502
WS 2016/17;SF220;Milch- und Molkereiwirtschaft;6;7;13
WS 2016/17;SF111;Mineralogie;13;8;21
WS 2016/17;SF273;Mittlere und neuere Geschichte;18;11;29
WS 2016/17;SF113;Musikerziehung;263;456;719
WS 2016/17;SF114;Musikwissenschaft/-geschichte;392;426;818
WS 2016/17;SF064;Naturschutz;30;55;85
WS 2016/17;SF223;Nautik/Seefahrt;108;27;135
WS 2016/17;SF287;Neue Medien;132;154;286
WS 2016/17;SF043;Neugriechisch;3;11;14
WS 2016/17;SF233;Nichtärztliche Heilberufe/Therapien;352;1497;1849
WS 2016/17;SF189;Niederdeutsch;-;-;-
WS 2016/17;SF119;Niederländisch;19;45;64
WS 2016/17;SF120;Nordistik/Skandinavist.(Nord.Phil.,Einzelsp.a.n.g);44;131;175
WS 2016/17;SF088;Optoelektronik;117;23;140
WS 2016/17;SF165;Orchestermusik;141;161;302
WS 2016/17;SF122;Orientalistik, Altorientalistik;92;143;235
WS 2016/17;SF044;Ost- und Südosteuropa;26;61;87
WS 2016/17;SF124;Ozeanografie;5;4;9
WS 2016/17;SF365;Pädagogik der frühen Kindheit;43;485;528
WS 2016/17;SF353;Pflanzenproduktion;42;27;69
WS 2016/17;SF234;Pflegewissenschaft/-management;371;1497;1868
WS 2016/17;SF126;Pharmazie;616;1445;2061
WS 2016/17;SF127;Philosophie;1453;1517;2970
WS 2016/17;SF128;Physik;5360;2155;7515
WS 2016/17;SF224;Physikalische Technik;531;177;708
WS 2016/17;SF129;Politikwissenschaft/Politologie;2462;2411;4873
WS 2016/17;SF263;Polizei/Verfassungsschutz;2916;1531;4447
WS 2016/17;SF206;Polnisch;4;22;26
WS 2016/17;SF131;Portugiesisch;7;19;26
WS 2016/17;SF132;Psychologie;2256;7462;9718
WS 2016/17;SF109;Publizistik (ab 2008 zu SF303);-;-;-
WS 2016/17;SF134;Raumplanung;319;478;797
WS 2016/17;SF256;Rechtspflege;141;505;646
WS 2016/17;SF135;Rechtswissenschaft;6577;9810;16387
WS 2016/17;SF310;Regenerative Energien;201;68;269
WS 2016/17;SF136;Religionswissenschaft;79;173;252
WS 2016/17;SF101;Restaurierungskunde;19;89;108
WS 2016/17;SF163;Rhythmik;-;-;-
WS 2016/17;SF137;Romanistik (Roman.Philologie,Einzelsprach. a.n.g.);122;545;667
WS 2016/17;SF139;Russisch;16;77;93
WS 2016/17;SF254;Sachunterricht (einschließlich Schulgarten);5;50;55
WS 2016/17;SF102;Schauspiel;43;40;83
WS 2016/17;SF142;Schiffbau/Schiffstechnik;131;28;159
WS 2016/17;SF361;Schulpädagogik;9;17;26
WS 2016/17;SF145;Sinologie/Koreanistik;129;333;462
WS 2016/17;SF146;Slawistik (Slawische Philologie);47;191;238
WS 2016/17;SF190;Sonderpädagogik;226;1659;1885
WS 2016/17;SF290;Sonstige Fächer;785;843;1628
WS 2016/17;SF036;Sonstige Regionalwissenschaften;43;66;109
WS 2016/17;SF207;Sorbisch;2;10;12
WS 2016/17;SF208;Soziale Arbeit;1774;6828;8602
WS 2016/17;SF147;Sozialkunde;156;202;358
WS 2016/17;SF046;Sozialmed./Öff. Gesundheitsw. (ab 2004 zu SF232);-;-;-
WS 2016/17;SF245;Sozialpädagogik;297;1546;1843
WS 2016/17;SF264;Sozialversicherung;174;415;589
WS 2016/17;SF253;Sozialwesen;790;3191;3981
WS 2016/17;SF148;Sozialwissenschaft;1314;2244;3558
WS 2016/17;SF149;Soziologie;953;1997;2950
WS 2016/17;SF150;Spanisch;212;648;860
WS 2016/17;SF166;Sportmanagement/Sportökonomie;520;174;694
WS 2016/17;SF098;Sportpädagogik/Sportpsychologie;569;496;1065
WS 2016/17;SF029;Sportwissenschaft;1322;1001;2323
WS 2016/17;SF151;Sprachheilpädagogik/Logopädie (ab 2016 zu SF190);-;-;-
WS 2016/17;SF429;Stahlbau;-;-;-
WS 2016/17;SF196;Studienkolleg;-;-;-
WS 2016/17;SF153;Südslawisch(Bulgarisch,Serbokroatisch,Slowen.usw.);-;1;1
WS 2016/17;SF106;Tanzpädagogik;30;55;85
WS 2016/17;SF144;Technische Kybernetik;78;29;107
WS 2016/17;SF118;Technomathematik;262;99;361
WS 2016/17;SF116;Textilgestaltung;85;421;506
WS 2016/17;SF225;Textil- und Bekleidungstechnik/-gewerbe;98;394;492
WS 2016/17;SF155;Theaterwissenschaft;114;416;530
WS 2016/17;SF156;Tiermedizin/Veterinärmedizin;155;876;1031
WS 2016/17;SF371;Tierproduktion;4;5;9
WS 2016/17;SF194;Tonmeister;65;15;80
WS 2016/17;SF274;Tourismuswirtschaft;357;1410;1767
WS 2016/17;SF074;Transport-/Fördertechnik;50;1;51
WS 2016/17;SF209;Tschechisch;1;3;4
WS 2016/17;SF158;Turkologie;18;49;67
WS 2016/17;SF458;Umweltschutz;197;210;407
WS 2016/17;SF457;Umwelttechnik (einschließlich Recycling);873;480;1353
WS 2016/17;SF548;Ur- und Frühgeschichte;37;41;78
WS 2016/17;SF226;Verfahrenstechnik;1093;772;1865
WS 2016/17;SF170;Verhaltensgestörtenpädagogik (ab 2016 zu SF190);-;-;-
WS 2016/17;SF089;Verkehrsingenieurwesen;532;206;738
WS 2016/17;SF268;Verkehrswesen;-;-;-
WS 2016/17;SF210;Verkehrswirtschaft;192;92;284
WS 2016/17;SF171;Vermessungswesen (Geodäsie);808;315;1123
WS 2016/17;SF213;Versorgungstechnik;624;102;726
WS 2016/17;SF172;Verwaltungswissenschaft/-wesen;1313;1868;3181
WS 2016/17;SF174;Volkskunde;41;143;184
WS 2016/17;SF175;Volkswirtschaftslehre;2484;1615;4099
WS 2016/17;SF094;Wasserbau;149;99;248
WS 2016/17;SF077;Wasserwirtschaft;200;120;320
WS 2016/17;SF227;Weinbau und Kellerwirtschaft;148;107;255
WS 2016/17;SF201;Werken (technisch)/Technologie;11;16;27
WS 2016/17;SF176;Werkerziehung;2;9;11
WS 2016/17;SF177;Werkstofftechnik;639;241;880
WS 2016/17;SF130;Westslawisch (allgemein und a.n.g.);4;9;13
WS 2016/17;SF178;Wirtschafts-/Sozialgeografie;2;5;7
WS 2016/17;SF183;Wirtschafts-/Sozialgeschichte;2;7;9
WS 2016/17;SF277;Wirtschaftsinformatik;7101;2025;9126
WS 2016/17;SF370;Wirtschaftsingenieurw. m. ingenieurwiss.Schwerpkt.;7897;2526;10423
WS 2016/17;SF179;Wirtschaftsingenieurw.m.wirtschaftswiss.Schwerpkt.;3933;1509;5442
WS 2016/17;SF276;Wirtschaftsmathematik;865;646;1511
WS 2016/17;SF181;Wirtschaftspädagogik;309;644;953
WS 2016/17;SF042;Wirtschaftsrecht;1322;1994;3316
WS 2016/17;SF184;Wirtschaftswissenschaften;7043;6364;13407
WS 2016/17;SF185;Zahnmedizin;489;939;1428
WS 2016/17;SF269;Zoll- und Steuerverwaltung;601;884;1485
WS 2017/18;SF141;Abfallwirtschaft;21;15;36
WS 2017/18;SF002;Afrikanistik;51;100;151
WS 2017/18;SF138;Agrarbiologie;71;72;143
WS 2017/18;SF125;Agrarökonomie;197;129;326
WS 2017/18;SF003;Agrarwissenschaft/Landwirtschaft;1419;1290;2709
WS 2017/18;SF001;Ägyptologie;69;93;162
WS 2017/18;SF152;Allg. Sprachwissenschaft/Indogermanistik;248;931;1179
WS 2017/18;SF188;Allgemeine Literaturwissenschaft;97;438;535
WS 2017/18;SF272;Alte Geschichte;4;9;13
WS 2017/18;SF006;Amerikanistik/Amerikakunde;172;387;559
WS 2017/18;SF007;Angewandte Kunst;201;358;559
WS 2017/18;SF284;Angewandte Sprachwissenschaft;124;683;807
WS 2017/18;SF140;Angewandte Systemwissenschaften;328;96;424
WS 2017/18;SF008;Anglistik/Englisch;2017;5748;7765
WS 2017/18;SF009;Anthropologie (Humanbiologie);13;66;79
WS 2017/18;SF010;Arabisch/Arabistik;39;68;107
WS 2017/18;SF011;Arbeitslehre/Wirtschaftslehre;80;176;256
WS 2017/18;SF257;Arbeits- und Berufsberatung;29;85;114
WS 2017/18;SF258;Arbeitsverwaltung;58;201;259
WS 2017/18;SF012;Archäologie;439;537;976
WS 2017/18;SF390;Archäometrie (Ingenieurarchäologie);1;-;1
WS 2017/18;SF013;Architektur;2548;3559;6107
WS 2017/18;SF255;Archivwesen;21;27;48
WS 2017/18;SF187;Asiatische Sprachen u.Kulturen/Asienwissenschaften;98;253;351
WS 2017/18;SF014;Astronomie, Astrophysik;29;23;52
WS 2017/18;SF143;Augenoptik;60;87;147
WS 2017/18;SF117;Ausländerpädagogik;20;26;46
WS 2017/18;SF015;Außereurop. Sprachen und Kult. in Ozeanien und Am.;10;23;33
WS 2017/18;SF259;Auswärtige Angelegenheiten;19;37;56
WS 2017/18;SF016;Baltistik;1;-;1
WS 2017/18;SF265;Bankwesen;44;41;85
WS 2017/18;SF017;Bauingenieurwesen/Ingenieurbau;6739;2655;9394
WS 2017/18;SF020;Bergbau/Bergtechnik;166;39;205
WS 2017/18;SF018;Berufsbezogene Fremdsprachenausbildung;110;366;476
WS 2017/18;SF270;Berufs- und Wirtschaftspädagogik;124;100;224
WS 2017/18;SF021;Betriebswirtschaftslehre;18654;19640;38294
WS 2017/18;SF262;Bibliothekswesen;1;8;9
WS 2017/18;SF022;Bibliothekswiss., -wesen (nicht an Verw.-FH);64;345;409
WS 2017/18;SF023;Bildende Kunst/Grafik;187;319;506
WS 2017/18;SF205;Bildhauerei/Plastik;20;22;42
WS 2017/18;SF025;Biochemie;568;888;1456
WS 2017/18;SF283;Biogeographie (ab 2012 ohne SF385);44;93;137
WS 2017/18;SF221;Bioinformatik;246;224;470
WS 2017/18;SF026;Biologie;2851;5783;8634
WS 2017/18;SF300;Biomedizin;115;204;319
WS 2017/18;SF282;Biotechnologie;966;1299;2265
WS 2017/18;SF027;Blinden-/Sehbehindertenpädagogik(ab 2016 zu SF190);-;-;-
WS 2017/18;SF028;Brauwesen/Getränketechnologie;148;18;166
WS 2017/18;SF260;Bundeswehrverwaltung;31;34;65
WS 2017/18;SF031;Byzantinistik;3;1;4
WS 2017/18;SF162;Caritaswissenschaft;2;6;8
WS 2017/18;SF032;Chemie;3956;3039;6995
WS 2017/18;SF033;Chemie-Ingenieurwesen/Chemietechnik;1006;598;1604
WS 2017/18;SF160;Computerlinguistik;95;113;208
WS 2017/18;SF200;Computer- und Kommunikationstechniken;589;396;985
WS 2017/18;SF034;Dänisch;1;7;8
WS 2017/18;SF035;Darstellende Kunst/Bühnenkunst/Regie;79;153;232
WS 2017/18;SF271;Deutsch als Fremdsprache oder als Zweitsprache;242;683;925
WS 2017/18;SF161;Diakoniewissenschaft;9;27;36
WS 2017/18;SF192;Dirigieren;25;11;36
WS 2017/18;SF037;Dokumentationswissenschaft;19;31;50
WS 2017/18;SF231;Druck- und Reproduktionstechnik;125;168;293
WS 2017/18;SF159;Edelstein- und Schmuckdesign;3;15;18
WS 2017/18;SF316;Elektronische Energietechnik;446;106;552
WS 2017/18;SF048;Elektrotechnik/Elektronik;9861;1666;11527
WS 2017/18;SF211;Energietechnik (ohne Elektrotechnik);755;239;994
WS 2017/18;SF320;Ernährungswissenschaft;115;618;733
WS 2017/18;SF321;Erwachsenenbildung und außerschulische Jugendbild.;49;167;216
WS 2017/18;SF051;Erziehungsschwierigenpädagogik (ab 2016 zu SF190);-;-;-
WS 2017/18;SF052;Erziehungswissenschaft (Pädagogik);1611;6976;8587
WS 2017/18;SF169;Ethik;26;50;76
WS 2017/18;SF173;Ethnologie;192;543;735
WS 2017/18;SF024;Europäische Ethnologie und Kulturwissenschaft;153;480;633
WS 2017/18;SF167;Europäische Wirtschaft;177;432;609
WS 2017/18;SF544;Ev. Religionspädagogik, kirchliche Bildungsarbeit;42;107;149
WS 2017/18;SF053;Evangelische Theologie, - Religionslehre;428;750;1178
WS 2017/18;SF464;Facility Management;300;228;528
WS 2017/18;SF235;Fahrzeugtechnik;1957;174;2131
WS 2017/18;SF212;Feinwerktechnik;113;11;124
WS 2017/18;SF202;Fertigungs-/Produktionstechnik;816;177;993
WS 2017/18;SF054;Film und Fernsehen;189;169;358
WS 2017/18;SF266;Finanzverwaltung;199;330;529
WS 2017/18;SF056;Finno-Ugristik;5;28;33
WS 2017/18;SF058;Forstwissenschaft, -wirtschaft;726;413;1139
WS 2017/18;SF059;Französisch;164;778;942
WS 2017/18;SF019;Friesisch (2007 aufgelöst);-;-;-
WS 2017/18;SF060;Gartenbau;206;188;394
WS 2017/18;SF062;Gehörlosen-/Schwerhörigenpäd. (ab 2016 zu SF190);-;-;-
WS 2017/18;SF063;Geistigbeh./Prakt.-Bildb.-Pädag.(ab 2016 zu SF190);-;-;-
WS 2017/18;SF050;Geografie/Erdkunde;1388;1638;3026
WS 2017/18;SF065;Geologie/Paläontologie;41;34;75
WS 2017/18;SF385;Geoökologie;92;119;211
WS 2017/18;SF066;Geophysik;93;91;184
WS 2017/18;SF039;Geowissenschaften;919;735;1654
WS 2017/18;SF067;Germanistik/Deutsch;2350;9281;11631
WS 2017/18;SF230;Gesang;88;148;236
WS 2017/18;SF068;Geschichte;2446;2231;4677
WS 2017/18;SF275;Geschichte der Mathematik und Naturwissenschaft;1;2;3
WS 2017/18;SF195;Gesundheitspädagogik;102;566;668
WS 2017/18;SF215;Gesundheitstechnik;1065;1131;2196
WS 2017/18;SF232;Gesundheitswissenschaften/-management;1544;4209;5753
WS 2017/18;SF216;Glastechnik/Keramik;21;6;27
WS 2017/18;SF069;Grafikdesign/Kommunikationsgestaltung;1009;2006;3015
WS 2017/18;SF070;Griechisch;24;31;55
WS 2017/18;SF115;Grundschul-/Primärstufenpädagogik;153;990;1143
WS 2017/18;SF071;Haushalts- und Ernährungswissenschaft;213;1068;1281
WS 2017/18;SF333;Haushaltswissenschaft;9;43;52
WS 2017/18;SF073;Hebräisch/Judaistik;25;34;59
WS 2017/18;SF082;Holz-/Fasertechnik;161;37;198
WS 2017/18;SF197;Holzbau;139;33;172
WS 2017/18;SF075;Holzwirtschaft;36;15;51
WS 2017/18;SF076;Hütten- und Gießereiwesen;89;43;132
WS 2017/18;SF078;Indologie;15;21;36
WS 2017/18;SF203;Industriedesign/Produktgestaltung;266;325;591
WS 2017/18;SF079;Informatik;14390;3093;17483
WS 2017/18;SF123;Ingenieurinformatik/Technische Informatik;2005;354;2359
WS 2017/18;SF242;Innenarchitektur;79;599;678
WS 2017/18;SF261;Innere Verwaltung;422;780;1202
WS 2017/18;SF080;Instrumentalmusik;572;572;1144
WS 2017/18;SF072;Interdisz. Studien (Schwerp. Ingenieurwissensch.);2157;915;3072
WS 2017/18;SF049;Interdisz. Studien (Schwerp. Naturwissenschaften);510;519;1029
WS 2017/18;SF030;Interdisz.Studien(Schwerp.Rechts-,Wirt.-u.Sozialw);826;1312;2138
WS 2017/18;SF004;Interdisz.Studien (Schwerpkt.Sprach-u.Kulturwiss.);757;2443;3200
WS 2017/18;SF040;Interdisz. Studien (Schwerpunkt Kunst, Kunstwiss.);44;84;128
WS 2017/18;SF182;Internationale Betriebswirtschaft/Management;3704;5274;8978
WS 2017/18;SF081;Iranistik;11;22;33
WS 2017/18;SF292;Islamische Studien;27;59;86
WS 2017/18;SF083;Islamwissenschaft;88;157;245
WS 2017/18;SF084;Italienisch;49;191;240
WS 2017/18;SF085;Japanologie;240;347;587
WS 2017/18;SF164;Jazz und Popularmusik;136;61;197
WS 2017/18;SF252;Journalistik (ab 2008 zu SF303);-;-;-
WS 2017/18;SF168;Justizvollzug;35;24;59
WS 2017/18;SF280;Kartografie;49;38;87
WS 2017/18;SF545;Kath. Religionspäd., kirchliche Bildungsarbeit;27;60;87
WS 2017/18;SF086;Katholische Theologie, - Religionslehre;257;420;677
WS 2017/18;SF180;Kaukasistik;-;-;-
WS 2017/18;SF241;Kerntechnik/Kernverfahrenstechnik;-;-;-
WS 2017/18;SF193;Kirchenmusik;30;21;51
WS 2017/18;SF005;Klassische Philologie;23;44;67
WS 2017/18;SF222;Kommunikations- und Informationstechnik;997;199;1196
WS 2017/18;SF303;Kommunikationswissenschaft/Publizistik;847;2063;2910
WS 2017/18;SF191;Komposition;59;25;84
WS 2017/18;SF087;Körperbehindertenpädagogik (ab 2016 zu SF190);-;-;-
WS 2017/18;SF047;Krankenpflege-Ausbildung (ab 2004 zu SF234);-;-;-
WS 2017/18;SF091;Kunsterziehung;119;531;650
WS 2017/18;SF092;Kunstgeschichte, Kunstwissenschaft;355;1465;1820
WS 2017/18;SF219;Kunststofftechnik;158;39;197
WS 2017/18;SF093;Landespflege/Landschaftsgestaltung;344;454;798
WS 2017/18;SF095;Latein;108;192;300
WS 2017/18;SF038;Lateinamerika;20;32;52
WS 2017/18;SF096;Lebensmittelchemie;136;370;506
WS 2017/18;SF097;Lebensmitteltechnologie;356;467;823
WS 2017/18;SF099;Lernbehindertenpädagogik (ab 2016 zu SF190);-;-;-
WS 2017/18;SF154;Lernbereich Gesellschaftslehre;23;30;53
WS 2017/18;SF186;Lernbereich Naturwissenschaft/Sachunterricht;82;458;540
WS 2017/18;SF090;Lernbereich Sprach- und Kulturwissenschaften;87;642;729
WS 2017/18;SF199;Lernbereich Technik;127;75;202
WS 2017/18;SF057;Luft- und Raumfahrttechnik;916;161;1077
WS 2017/18;SF204;Malerei;51;58;109
WS 2017/18;SF198;Managem.im Gesundh.-u.Sozialber.(ab 2004 zu SF232);-;-;-
WS 2017/18;SF103;Markscheidewesen;-;-;-
WS 2017/18;SF104;Maschinenbau/-wesen;15168;2151;17319
WS 2017/18;SF294;Materialwissenschaften;263;86;349
WS 2017/18;SF105;Mathematik;4444;4971;9415
WS 2017/18;SF237;Mathematische Statistik/Wahrscheinlichkeitsrechn.;139;148;287
WS 2017/18;SF380;Mechatronik;3282;387;3669
WS 2017/18;SF121;Medieninformatik;1816;1048;2864
WS 2017/18;SF133;Medienk./Komm.-/Infowissenschaft (ab 08 zu SF303);-;-;-
WS 2017/18;SF305;Medientechnik;727;681;1408
WS 2017/18;SF304;Medienwirtschaft/Medienmanagement;560;1127;1687
WS 2017/18;SF302;Medienwissenschaft;524;1396;1920
WS 2017/18;SF107;Medizin (Allgemein-Medizin);3511;6149;9660
WS 2017/18;SF247;Medizinische Informatik;279;241;520
WS 2017/18;SF061;Meliorationswesen;-;-;-
WS 2017/18;SF108;Metalltechnik;101;21;122
WS 2017/18;SF110;Meteorologie;148;145;293
WS 2017/18;SF157;Mikroelektronik;55;16;71
WS 2017/18;SF286;Mikrosystemtechnik;346;84;430
WS 2017/18;SF220;Milch- und Molkereiwirtschaft;9;4;13
WS 2017/18;SF111;Mineralogie;1;1;2
WS 2017/18;SF273;Mittlere und neuere Geschichte;10;16;26
WS 2017/18;SF113;Musikerziehung;287;390;677
WS 2017/18;SF114;Musikwissenschaft/-geschichte;334;430;764
WS 2017/18;SF064;Naturschutz;36;74;110
WS 2017/18;SF223;Nautik/Seefahrt;144;41;185
WS 2017/18;SF287;Neue Medien;102;133;235
WS 2017/18;SF043;Neugriechisch;5;9;14
WS 2017/18;SF233;Nichtärztliche Heilberufe/Therapien;410;1668;2078
WS 2017/18;SF189;Niederdeutsch;-;-;-
WS 2017/18;SF119;Niederländisch;16;67;83
WS 2017/18;SF120;Nordistik/Skandinavist.(Nord.Phil.,Einzelsp.a.n.g);48;184;232
WS 2017/18;SF088;Optoelektronik;48;31;79
WS 2017/18;SF165;Orchestermusik;153;179;332
WS 2017/18;SF122;Orientalistik, Altorientalistik;89;165;254
WS 2017/18;SF044;Ost- und Südosteuropa;31;48;79
WS 2017/18;SF124;Ozeanografie;4;2;6
WS 2017/18;SF365;Pädagogik der frühen Kindheit;47;559;606
WS 2017/18;SF353;Pflanzenproduktion;43;34;77
WS 2017/18;SF234;Pflegewissenschaft/-management;367;1459;1826
WS 2017/18;SF126;Pharmazie;582;1456;2038
WS 2017/18;SF127;Philosophie;1544;1617;3161
WS 2017/18;SF128;Physik;5565;2219;7784
WS 2017/18;SF224;Physikalische Technik;507;151;658
WS 2017/18;SF129;Politikwissenschaft/Politologie;2712;2554;5266
WS 2017/18;SF263;Polizei/Verfassungsschutz;3500;1805;5305
WS 2017/18;SF206;Polnisch;2;15;17
WS 2017/18;SF131;Portugiesisch;3;15;18
WS 2017/18;SF132;Psychologie;2250;7847;10097
WS 2017/18;SF109;Publizistik (ab 2008 zu SF303);-;-;-
WS 2017/18;SF134;Raumplanung;341;459;800
WS 2017/18;SF256;Rechtspflege;172;508;680
WS 2017/18;SF135;Rechtswissenschaft;6601;9925;16526
WS 2017/18;SF310;Regenerative Energien;202;66;268
WS 2017/18;SF136;Religionswissenschaft;77;110;187
WS 2017/18;SF101;Restaurierungskunde;16;63;79
WS 2017/18;SF163;Rhythmik;1;2;3
WS 2017/18;SF137;Romanistik (Roman.Philologie,Einzelsprach. a.n.g.);162;540;702
WS 2017/18;SF139;Russisch;25;86;111
WS 2017/18;SF254;Sachunterricht (einschließlich Schulgarten);19;61;80
WS 2017/18;SF102;Schauspiel;34;39;73
WS 2017/18;SF142;Schiffbau/Schiffstechnik;134;25;159
WS 2017/18;SF361;Schulpädagogik;12;9;21
WS 2017/18;SF145;Sinologie/Koreanistik;126;329;455
WS 2017/18;SF146;Slawistik (Slawische Philologie);52;152;204
WS 2017/18;SF190;Sonderpädagogik;298;1792;2090
WS 2017/18;SF290;Sonstige Fächer;930;943;1873
WS 2017/18;SF036;Sonstige Regionalwissenschaften;42;80;122
WS 2017/18;SF207;Sorbisch;-;5;5
WS 2017/18;SF208;Soziale Arbeit;1866;7662;9528
WS 2017/18;SF147;Sozialkunde;166;202;368
WS 2017/18;SF046;Sozialmed./Öff. Gesundheitsw. (ab 2004 zu SF232);-;-;-
WS 2017/18;SF245;Sozialpädagogik;253;1316;1569
WS 2017/18;SF264;Sozialversicherung;179;400;579
WS 2017/18;SF253;Sozialwesen;812;3261;4073
WS 2017/18;SF148;Sozialwissenschaft;1500;2327;3827
WS 2017/18;SF149;Soziologie;924;2073;2997
WS 2017/18;SF150;Spanisch;216;668;884
WS 2017/18;SF166;Sportmanagement/Sportökonomie;589;213;802
WS 2017/18;SF098;Sportpädagogik/Sportpsychologie;645;564;1209
WS 2017/18;SF029;Sportwissenschaft;1408;1114;2522
WS 2017/18;SF151;Sprachheilpädagogik/Logopädie (ab 2016 zu SF190);-;-;-
WS 2017/18;SF429;Stahlbau;-;-;-
WS 2017/18;SF196;Studienkolleg;-;-;-
WS 2017/18;SF153;Südslawisch(Bulgarisch,Serbokroatisch,Slowen.usw.);1;1;2
WS 2017/18;SF106;Tanzpädagogik;31;46;77
WS 2017/18;SF144;Technische Kybernetik;70;19;89
WS 2017/18;SF118;Technomathematik;277;104;381
WS 2017/18;SF116;Textilgestaltung;81;372;453
WS 2017/18;SF225;Textil- und Bekleidungstechnik/-gewerbe;78;366;444
WS 2017/18;SF155;Theaterwissenschaft;118;356;474
WS 2017/18;SF156;Tiermedizin/Veterinärmedizin;154;840;994
WS 2017/18;SF371;Tierproduktion;1;2;3
WS 2017/18;SF194;Tonmeister;65;8;73
WS 2017/18;SF274;Tourismuswirtschaft;419;1678;2097
WS 2017/18;SF074;Transport-/Fördertechnik;58;2;60
WS 2017/18;SF209;Tschechisch;3;14;17
WS 2017/18;SF158;Turkologie;19;48;67
WS 2017/18;SF458;Umweltschutz;221;276;497
WS 2017/18;SF457;Umwelttechnik (einschließlich Recycling);828;523;1351
WS 2017/18;SF548;Ur- und Frühgeschichte;38;34;72
WS 2017/18;SF226;Verfahrenstechnik;995;710;1705
WS 2017/18;SF170;Verhaltensgestörtenpädagogik (ab 2016 zu SF190);-;-;-
WS 2017/18;SF089;Verkehrsingenieurwesen;641;183;824
WS 2017/18;SF268;Verkehrswesen;-;-;-
WS 2017/18;SF210;Verkehrswirtschaft;181;76;257
WS 2017/18;SF171;Vermessungswesen (Geodäsie);742;327;1069
WS 2017/18;SF213;Versorgungstechnik;525;102;627
WS 2017/18;SF172;Verwaltungswissenschaft/-wesen;1390;2215;3605
WS 2017/18;SF174;Volkskunde;34;95;129
WS 2017/18;SF175;Volkswirtschaftslehre;2274;1506;3780
WS 2017/18;SF094;Wasserbau;181;107;288
WS 2017/18;SF077;Wasserwirtschaft;159;105;264
WS 2017/18;SF227;Weinbau und Kellerwirtschaft;155;91;246
WS 2017/18;SF201;Werken (technisch)/Technologie;17;26;43
WS 2017/18;SF176;Werkerziehung;3;16;19
WS 2017/18;SF177;Werkstofftechnik;669;263;932
WS 2017/18;SF130;Westslawisch (allgemein und a.n.g.);1;10;11
WS 2017/18;SF178;Wirtschafts-/Sozialgeografie;1;4;5
WS 2017/18;SF183;Wirtschafts-/Sozialgeschichte;15;13;28
WS 2017/18;SF277;Wirtschaftsinformatik;7313;2019;9332
WS 2017/18;SF370;Wirtschaftsingenieurw. m. ingenieurwiss.Schwerpkt.;7954;2590;10544
WS 2017/18;SF179;Wirtschaftsingenieurw.m.wirtschaftswiss.Schwerpkt.;3884;1412;5296
WS 2017/18;SF276;Wirtschaftsmathematik;886;556;1442
WS 2017/18;SF181;Wirtschaftspädagogik;348;640;988
WS 2017/18;SF042;Wirtschaftsrecht;1207;1847;3054
WS 2017/18;SF184;Wirtschaftswissenschaften;6831;6226;13057
WS 2017/18;SF185;Zahnmedizin;503;977;1480
WS 2017/18;SF269;Zoll- und Steuerverwaltung;857;1154;2011
